customer_id,frequency,monetary,recency,R,F,M,RFM_Score,Segment
12346,12,77556.46,325,2,4,4,10,High-Value
12347,8,4921.53,1,4,4,4,12,High-Value
12348,5,1658.3999999999999,74,3,3,3,9,High-Value
12349,3,3678.69,18,4,2,4,10,High-Value
12350,1,294.40000000000003,309,2,1,1,4,One-Time
12351,1,300.93,374,2,1,1,4,One-Time
12352,9,1729.54,35,3,4,3,10,High-Value
12353,2,406.76,203,2,2,2,6,Other
12354,1,1079.4,231,2,1,3,6,Other
12355,2,947.61,213,2,2,3,7,Other
12356,6,5611.7300000000005,22,4,3,4,11,High-Value
12357,2,17437.66,32,3,2,4,9,High-Value
12358,5,3447.07,1,4,3,4,11,High-Value
12359,10,8873.39,57,3,4,4,11,High-Value
12360,6,3612.89,51,3,3,4,10,High-Value
12361,4,451.25,286,2,3,2,7,Other
12362,10,4737.2300000000005,2,4,4,4,12,High-Value
12363,2,552.0,109,2,2,2,6,Other
12364,4,1208.1,7,4,3,3,10,High-Value
12365,1,320.69,290,2,1,1,4,One-Time
12366,1,500.24,633,1,1,2,4,At-Risk
12367,1,150.9,3,4,1,1,6,One-Time
12368,1,917.7,627,1,1,3,5,At-Risk
12369,3,1511.15,412,1,2,3,6,At-Risk
12370,7,3956.56,50,3,3,4,10,High-Value
12371,4,3347.38,59,3,3,4,10,High-Value
12372,3,1196.04,71,3,2,3,8,Other
12373,3,927.6500000000001,310,2,2,3,7,Other
12374,3,2669.2200000000003,24,4,2,4,10,High-Value
12375,2,377.5,10,4,2,2,8,Other
12376,2,383.15,389,1,2,2,5,At-Risk
12377,4,3266.32,314,2,3,4,9,High-Value
12378,2,5416.32,129,2,2,4,8,Other
12379,4,1470.22,81,3,3,3,9,High-Value
12380,8,7210.650000000001,21,4,4,4,12,High-Value
12381,3,1474.81,4,4,2,3,9,High-Value
12383,5,1628.56,184,2,3,3,8,Other
12384,2,425.27,28,3,2,2,7,Other
12385,1,1668.4,378,2,1,3,6,Other
12386,2,401.9,337,2,2,2,6,Other
12387,1,143.94,414,1,1,1,3,At-Risk
12388,8,3901.11,15,4,4,4,12,High-Value
12389,3,1433.33,402,1,2,3,6,At-Risk
12390,1,504.84000000000003,79,3,1,2,6,Other
12391,6,2724.84,21,4,3,4,11,High-Value
12392,1,234.75,590,1,1,1,3,At-Risk
12393,6,2399.45,71,3,3,4,10,High-Value
12394,2,1080.48,63,3,2,3,8,Other
12395,15,4241.17,18,4,4,4,12,High-Value
12396,1,931.4300000000001,673,1,1,3,5,At-Risk
12397,2,2214.9,35,3,2,3,8,Other
12398,1,1435.66,45,3,1,3,7,Other
12399,7,1842.3,118,2,3,3,8,Other
12400,1,205.25,413,1,1,1,3,At-Risk
12401,1,69.3,302,2,1,1,4,One-Time
12402,6,1136.9,322,2,3,3,8,Other
12403,2,947.36,49,3,2,3,8,Other
12405,1,1390.39,148,2,1,3,6,Other
12406,5,6390.36,21,4,3,4,11,High-Value
12407,5,1507.12,49,3,3,3,9,High-Value
12408,8,3905.77,32,3,4,4,11,High-Value
12409,7,23419.29,78,3,3,4,10,High-Value
12410,3,773.71,308,2,2,2,6,Other
12411,1,346.9,409,1,1,2,4,At-Risk
12412,6,2404.93,74,3,3,4,10,High-Value
12413,4,871.45,66,3,3,3,9,High-Value
12414,4,532.41,216,2,3,2,7,Other
12415,24,144033.37,23,4,4,4,12,High-Value
12416,1,202.56,656,1,1,1,3,At-Risk
12417,20,5998.41,2,4,4,4,12,High-Value
12418,4,2021.2,112,2,3,3,8,Other
12419,2,391.01,385,1,2,2,5,At-Risk
12420,1,600.39,63,3,1,2,6,Other
12421,6,874.6,15,4,3,3,10,High-Value
12422,12,3639.35,95,2,4,4,10,High-Value
12423,10,2301.39,0,4,4,4,12,High-Value
12424,4,3340.0299999999997,162,2,3,4,9,High-Value
12425,2,1741.41,77,3,2,3,8,Other
12426,2,1201.21,194,2,2,3,7,Other
12427,3,699.8000000000001,21,4,2,2,8,Other
12428,8,6405.26,25,3,4,4,11,High-Value
12429,8,5842.41,8,4,4,4,12,High-Value
12430,1,216.4,42,3,1,1,5,One-Time
12431,25,10102.220000000001,35,3,4,4,11,High-Value
12432,4,4359.32,42,3,3,4,10,High-Value
12433,10,16794.14,0,4,4,4,12,High-Value
12434,3,1103.43,84,3,2,3,8,Other
12435,6,13925.93,79,3,3,4,10,High-Value
12436,1,429.01,99,2,1,2,5,Other
12437,38,11282.4,1,4,4,4,12,High-Value
12438,2,2466.85,13,4,2,4,10,High-Value
12439,2,1142.88,682,1,2,3,6,At-Risk
12440,2,739.2,461,1,2,2,5,At-Risk
12441,1,155.55,366,2,1,1,4,One-Time
12442,1,144.06,2,4,1,1,6,One-Time
12443,1,365.31,731,1,1,2,4,At-Risk
12444,5,4085.46,20,4,3,4,11,High-Value
12445,2,378.98,21,4,2,2,8,Other
12446,1,1002.3100000000001,57,3,1,3,7,Other
12447,1,431.49,242,2,1,2,5,Other
12448,1,365.45,43,3,1,2,6,Other
12449,5,4274.89,21,4,3,4,11,High-Value
12450,5,688.2,155,2,3,2,7,Other
12451,8,12629.88,10,4,4,4,12,High-Value
12452,1,348.57,16,4,1,2,7,Other
12453,1,707.09,133,2,1,2,5,Other
12454,4,16459.78,55,3,3,4,10,High-Value
12455,9,5722.95,72,3,4,4,11,High-Value
12456,3,2581.04,43,3,2,4,9,High-Value
12457,7,2555.91,65,3,3,4,10,High-Value
12458,4,1502.49,70,3,3,3,9,High-Value
12459,1,398.36,604,1,1,2,4,At-Risk
12460,1,296.65,455,1,1,1,3,At-Risk
12461,1,626.88,154,2,1,2,5,Other
12462,2,937.59,18,4,2,3,9,High-Value
12463,4,1200.78,52,3,3,3,9,High-Value
12464,8,957.05,9,4,4,3,11,High-Value
12465,2,682.19,16,4,2,2,8,Other
12467,1,132.8,422,1,1,1,3,At-Risk
12468,5,3238.7400000000002,187,2,3,4,9,High-Value
12469,2,3070.54,522,1,2,4,7,At-Risk
12470,1,211.95,689,1,1,1,3,At-Risk
12471,71,35099.9,1,4,4,4,12,High-Value
12472,19,14971.29,31,3,4,4,11,High-Value
12473,3,2585.73,53,3,2,4,9,High-Value
12474,29,11310.75,16,4,4,4,12,High-Value
12475,2,1065.64,53,3,2,3,8,Other
12476,18,12319.91,15,4,4,4,12,High-Value
12477,9,20276.37,22,4,4,4,12,High-Value
12478,1,545.99,3,4,1,2,7,Other
12479,1,473.2,10,4,1,2,7,Other
12480,7,4834.85,27,3,3,4,10,High-Value
12481,14,11033.51,22,4,4,4,12,High-Value
12482,27,21941.72,575,1,4,4,9,High-Value
12483,19,4069.1800000000003,16,4,4,4,12,High-Value
12484,9,5557.1,34,3,4,4,11,High-Value
12485,1,708.1,528,1,1,2,4,At-Risk
12486,1,917.28,431,1,1,3,5,At-Risk
12487,1,285.3,730,1,1,1,3,At-Risk
12488,3,1244.66,9,4,2,3,9,High-Value
12489,1,298.93,335,2,1,1,4,One-Time
12490,20,8764.64,4,4,4,4,12,High-Value
12491,1,424.40000000000003,38,3,1,2,6,Other
12492,3,607.21,62,3,2,2,7,Other
12493,2,379.74,165,2,2,2,6,Other
12494,9,1563.27,15,4,4,3,11,High-Value
12495,1,277.4,640,1,1,1,3,At-Risk
12496,2,45.34,619,1,2,1,4,At-Risk
12497,3,5996.5,81,3,2,4,9,High-Value
12498,3,349.70000000000005,20,4,2,2,8,Other
12499,1,357.72,559,1,1,2,4,At-Risk
12500,18,5559.21,22,4,4,4,12,High-Value
12501,1,2025.39,336,2,1,3,6,Other
12502,5,2995.87,95,2,3,4,9,High-Value
12503,1,896.0,583,1,1,3,5,At-Risk
12504,4,689.05,17,4,3,2,9,High-Value
12505,1,787.2,408,1,1,2,4,At-Risk
12506,1,73.5,232,2,1,1,4,One-Time
12507,4,1508.06,133,2,3,3,8,Other
12508,2,397.88,25,3,2,2,7,Other
12509,1,158.5,283,2,1,1,4,One-Time
12510,7,3039.03,142,2,3,4,9,High-Value
12511,1,3084.02,428,1,1,4,6,At-Risk
12512,2,132.18,65,3,2,1,6,Other
12513,1,558.29,112,2,1,2,5,Other
12514,2,1597.76,266,2,2,3,7,Other
12515,1,278.7,352,2,1,1,4,One-Time
12516,4,2288.62,77,3,3,4,10,High-Value
12517,4,2301.6,27,3,3,4,10,High-Value
12518,5,1840.89,0,4,3,3,10,High-Value
12519,2,626.54,63,3,2,2,7,Other
12520,5,2346.26,78,3,3,4,10,High-Value
12521,1,545.6800000000001,142,2,1,2,5,Other
12522,2,156.72,38,3,2,1,6,Other
12523,23,4010.35,18,4,4,4,12,High-Value
12524,17,9794.11,8,4,4,4,12,High-Value
12525,3,883.73,497,1,2,3,6,At-Risk
12526,3,1172.66,0,4,2,3,9,High-Value
12527,5,717.51,81,3,3,2,8,Loyal
12528,6,1645.48,8,4,3,3,10,High-Value
12529,1,316.48,527,1,1,1,3,At-Risk
12530,9,3381.26,59,3,4,4,11,High-Value
12531,2,1771.2,14,4,2,3,9,High-Value
12532,1,313.83000000000004,29,3,1,1,5,One-Time
12533,2,1223.89,627,1,2,3,6,At-Risk
12534,1,981.18,130,2,1,3,6,Other
12535,2,716.35,91,3,2,2,7,Other
12536,1,4279.71,58,3,1,4,8,Other
12537,1,612.94,408,1,1,2,4,At-Risk
12538,2,640.45,28,3,2,2,7,Other
12539,7,11186.75,21,4,3,4,11,High-Value
12540,32,19250.49,19,4,4,4,12,High-Value
12541,3,841.18,29,3,2,2,7,Other
12542,2,481.88,483,1,2,2,5,At-Risk
12543,1,840.25,447,1,1,2,4,At-Risk
12544,1,316.7,35,3,1,1,5,One-Time
12545,2,832.39,74,3,2,2,7,Other
12546,2,1021.5,46,3,2,3,8,Other
12547,3,299.58,197,2,2,1,5,Other
12548,1,67.19999999999999,165,2,1,1,4,One-Time
12549,5,1570.68,575,1,3,3,7,At-Risk
12550,1,824.83,78,3,1,2,6,Other
12551,1,168.0,357,2,1,1,4,One-Time
12552,1,317.82,39,3,1,1,5,One-Time
12553,12,4104.75,7,4,4,4,12,High-Value
12554,1,384.5,448,1,1,2,4,At-Risk
12556,2,599.5600000000001,49,3,2,2,7,Other
12557,8,18096.14,15,4,4,4,12,High-Value
12558,1,269.96,7,4,1,1,6,One-Time
12559,2,525.71,310,2,2,2,6,Other
12560,2,1918.01,4,4,2,3,9,High-Value
12561,1,238.85,302,2,1,1,4,One-Time
12562,9,4426.92,7,4,4,4,12,High-Value
12563,1,221.24,408,1,1,1,3,At-Risk
12564,1,402.90000000000003,260,2,1,2,5,Other
12565,1,145.92000000000002,288,2,1,1,4,One-Time
12566,1,297.65,85,3,1,1,5,One-Time
12567,15,10741.48,22,4,4,4,12,High-Value
12568,1,52.0,644,1,1,1,3,At-Risk
12569,32,3152.69,1,4,4,4,12,High-Value
12571,2,519.61,39,3,2,2,7,Other
12572,2,912.4200000000001,8,4,2,3,9,High-Value
12573,5,717.41,226,2,3,2,7,Other
12574,1,182.45000000000002,315,2,1,1,4,One-Time
12575,2,568.82,456,1,2,2,5,At-Risk
12576,8,2062.7200000000003,35,3,4,3,10,High-Value
12577,8,1613.1499999999999,34,3,4,3,10,High-Value
12578,4,4026.4500000000003,20,4,3,4,11,High-Value
12579,1,386.42,77,3,1,2,6,Other
12580,2,962.9,246,2,2,3,7,Other
12581,1,179.71,39,3,1,1,5,One-Time
12582,4,1820.4,238,2,3,3,8,Other
12583,27,12493.58,2,4,4,4,12,High-Value
12584,9,2254.15,3,4,4,4,12,High-Value
12585,2,1824.1,233,2,2,3,7,Other
12586,4,2062.67,16,4,3,3,10,High-Value
12587,1,104.0,7,4,1,1,6,One-Time
12588,3,718.78,38,3,2,2,7,Other
12589,6,3294.91,28,3,3,4,10,High-Value
12590,1,9341.26,210,2,1,4,7,Other
12591,3,1114.95,316,2,2,3,7,Other
12592,4,1723.64,91,3,3,3,9,High-Value
12593,3,382.1,108,2,2,2,6,Other
12594,14,4890.110000000001,37,3,4,4,11,High-Value
12595,1,281.02,504,1,1,1,3,At-Risk
12596,2,450.27,50,3,2,2,7,Other
12597,4,3195.22,18,4,3,4,11,High-Value
12598,10,4192.09,9,4,4,4,12,High-Value
12599,13,2026.72,28,3,4,3,10,High-Value
12600,20,4385.85,28,3,4,4,11,High-Value
12601,6,573.26,189,2,3,2,7,Other
12602,1,153.12,58,3,1,1,5,One-Time
12603,1,613.1999999999999,21,4,1,2,7,Other
12604,2,236.18,78,3,2,1,6,Other
12605,3,1124.95,375,2,2,3,7,Other
12607,1,1579.51,59,3,1,3,7,Other
12608,1,415.79,404,1,1,2,4,At-Risk
12609,9,3021.86,77,3,4,4,11,High-Value
12610,4,1747.54,22,4,3,3,10,High-Value
12611,1,1193.32,51,3,1,3,7,Other
12612,1,668.04,73,3,1,2,6,Other
12613,9,6277.37,56,3,4,4,11,High-Value
12614,1,315.6,277,2,1,1,4,One-Time
12615,8,5362.9800000000005,1,4,4,4,12,High-Value
12616,3,1023.1,94,3,2,3,8,Other
12617,1,352.98,28,3,1,2,6,Other
12618,1,137.31,21,4,1,1,6,One-Time
12619,9,3085.7,15,4,4,4,12,High-Value
12620,3,1303.41,14,4,2,3,9,High-Value
12621,35,22097.2,1,4,4,4,12,High-Value
12622,1,162.1,231,2,1,1,4,One-Time
12623,7,3315.84,275,2,3,4,9,High-Value
12624,2,569.13,105,2,2,2,6,Other
12625,4,4678.88,211,2,3,4,9,High-Value
12626,9,5954.4800000000005,22,4,4,4,12,High-Value
12627,6,4082.53,10,4,3,4,11,High-Value
12628,3,732.46,3,4,2,2,8,Other
12629,2,1198.22,385,1,2,3,6,At-Risk
12630,2,1030.88,9,4,2,3,9,High-Value
12631,6,3321.57,56,3,3,4,10,High-Value
12632,2,714.88,520,1,2,2,5,At-Risk
12633,7,5156.16,58,3,3,4,10,High-Value
12634,1,360.0,547,1,1,2,4,At-Risk
12635,4,2624.41,89,3,3,4,10,High-Value
12637,12,8085.81,66,3,4,4,11,High-Value
12638,2,681.49,32,3,2,2,7,Other
12639,3,1072.3700000000001,238,2,2,3,7,Other
12640,3,994.58,23,4,2,3,9,High-Value
12641,1,145.9,114,2,1,1,4,One-Time
12642,3,905.26,24,4,2,3,9,High-Value
12643,11,7803.82,127,2,4,4,10,High-Value
12644,4,1900.49,129,2,3,3,8,Other
12645,8,3215.3,33,3,4,4,11,High-Value
12646,2,1346.97,4,4,2,3,9,High-Value
12647,35,14109.55,21,4,4,4,12,High-Value
12648,4,1039.0,154,2,3,3,8,Other
12649,8,2096.65,106,2,4,3,9,High-Value
12650,1,242.44,2,4,1,1,6,One-Time
12651,4,377.75,334,2,3,2,7,Other
12652,2,891.0300000000001,330,2,2,3,7,Other
12653,3,4160.83,148,2,2,4,8,Other
12654,5,529.98,10,4,3,2,9,High-Value
12655,1,243.35,423,1,1,1,3,At-Risk
12656,8,5723.83,16,4,4,4,12,High-Value
12657,4,1427.18,10,4,3,3,10,High-Value
12658,1,632.05,18,4,1,2,7,Other
12659,1,73.67999999999999,29,3,1,1,5,One-Time
12660,1,227.10000000000002,10,4,1,1,6,One-Time
12661,1,162.0,435,1,1,1,3,At-Risk
12662,20,6130.54,0,4,4,4,12,High-Value
12663,2,185.4,624,1,2,1,4,At-Risk
12664,11,5420.04,7,4,4,4,12,High-Value
12665,3,259.6,324,2,2,1,5,Other
12666,1,1248.42,393,1,1,3,5,At-Risk
12667,1,460.13,57,3,1,2,6,Other
12668,9,9906.03,11,4,4,4,12,High-Value
12669,2,1427.73,150,2,2,3,7,Other
12670,7,3436.29,9,4,3,4,11,High-Value
12671,1,2622.481,605,1,1,4,6,At-Risk
12672,2,407.05,329,2,2,2,6,Other
12673,3,1140.02,4,4,2,3,9,High-Value
12674,4,1844.6,38,3,3,3,9,High-Value
12675,2,873.25,553,1,2,3,6,At-Risk
12676,10,2333.09,24,4,4,4,12,High-Value
12677,2,359.1,554,1,2,2,5,At-Risk
12678,15,32595.18,41,3,4,4,11,High-Value
12679,4,951.02,58,3,3,3,9,High-Value
12680,4,790.81,0,4,3,2,9,High-Value
12681,44,26936.760000000002,14,4,4,4,12,High-Value
12682,51,20736.22,3,4,4,4,12,High-Value
12683,20,10445.7,3,4,4,4,12,High-Value
12684,6,2073.63,7,4,3,3,10,High-Value
12685,6,2575.08,27,3,3,4,10,High-Value
12686,1,71.14,371,2,1,1,4,One-Time
12687,1,1858.91,480,1,1,3,5,At-Risk
12688,1,4873.81,113,2,1,4,7,Other
12689,2,1139.6100000000001,25,3,2,3,8,Other
12690,1,335.01,205,2,1,1,4,One-Time
12691,6,1044.4,27,3,3,3,9,High-Value
12692,1,110.95,636,1,1,1,3,At-Risk
12693,7,1415.02,126,2,3,3,8,Other
12694,3,1663.35,69,3,2,3,8,Other
12695,7,1371.1200000000001,6,4,3,3,10,High-Value
12696,2,731.91,434,1,2,2,5,At-Risk
12697,3,757.59,28,3,2,2,7,Other
12698,1,285.75,589,1,1,1,3,At-Risk
12699,1,566.11,417,1,1,2,4,At-Risk
12700,4,4525.99,7,4,3,4,11,High-Value
12701,6,2248.41,79,3,3,4,10,High-Value
12702,1,201.0,19,4,1,1,6,One-Time
12703,4,898.53,70,3,3,3,9,High-Value
12704,8,1740.84,6,4,4,3,11,High-Value
12705,13,11114.1,14,4,4,4,12,High-Value
12707,1,603.42,291,2,1,2,5,Other
12708,18,4559.66,29,3,4,4,11,High-Value
12709,32,29487.18,14,4,4,4,12,High-Value
12710,3,1023.02,96,2,2,3,7,Other
12711,2,1213.05,611,1,2,3,6,At-Risk
12712,21,5985.03,28,3,4,4,11,High-Value
12713,1,794.55,0,4,1,2,7,Other
12714,12,12815.710000000001,8,4,4,4,12,High-Value
12715,1,263.36,105,2,1,1,4,One-Time
12716,2,963.49,3,4,2,3,9,High-Value
12717,3,1058.91,150,2,2,3,7,Other
12718,1,202.25,70,3,1,1,5,One-Time
12719,2,572.95,4,4,2,2,8,Other
12720,29,6905.28,2,4,4,4,12,High-Value
12721,8,3635.08,31,3,4,4,11,High-Value
12722,4,979.63,84,3,3,3,9,High-Value
12723,5,707.07,3,4,3,2,9,High-Value
12724,7,2083.52,4,4,3,3,10,High-Value
12725,3,1906.76,370,2,2,3,7,Other
12726,11,3690.6,27,3,4,4,11,High-Value
12727,10,4905.53,10,4,4,4,12,High-Value
12728,5,926.17,70,3,3,3,9,High-Value
12729,1,417.01,113,2,1,2,5,Other
12730,1,703.25,521,1,1,2,4,At-Risk
12731,17,25631.71,23,4,4,4,12,High-Value
12732,1,218.26,179,2,1,1,4,One-Time
12733,4,2424.02,233,2,3,4,9,High-Value
12734,3,603.65,352,2,2,2,6,Other
12735,2,689.5699999999999,314,2,2,2,6,Other
12736,1,144.0,332,2,1,1,4,One-Time
12738,1,137.35,371,2,1,1,4,One-Time
12739,2,2421.23,98,2,2,4,8,Other
12740,1,427.6,63,3,1,2,6,Other
12741,1,236.07,532,1,1,1,3,At-Risk
12742,1,1201.52,625,1,1,3,5,At-Risk
12743,2,540.13,133,2,2,2,6,Other
12744,8,13158.16,55,3,4,4,11,High-Value
12745,2,723.85,486,1,2,2,5,At-Risk
12746,1,254.55,540,1,1,1,3,At-Risk
12747,26,8898.48,1,4,4,4,12,High-Value
12748,322,49176.74,0,4,4,4,12,High-Value
12749,9,6847.36,3,4,4,4,12,High-Value
12750,1,275.88,128,2,1,1,4,One-Time
12751,1,268.27,444,1,1,1,3,At-Risk
12752,1,4366.78,80,3,1,4,8,Other
12753,6,21429.39,22,4,3,4,11,High-Value
12754,3,3010.7400000000002,235,2,2,4,8,Other
12755,11,5236.26,280,2,4,4,10,High-Value
12756,1,112.08,86,3,1,1,5,One-Time
12757,9,4176.75,15,4,4,4,12,High-Value
12758,7,9903.24,116,2,3,4,9,High-Value
12759,8,4618.74,51,3,4,4,11,High-Value
12760,1,317.8,455,1,1,1,3,At-Risk
12761,1,712.95,464,1,1,2,4,At-Risk
12762,2,1702.52,7,4,2,3,9,High-Value
12763,2,494.08,137,2,2,2,6,Other
12764,1,1693.88,316,2,1,3,6,Other
12765,6,1299.58,471,1,3,3,7,At-Risk
12766,9,8134.99,3,4,4,4,12,High-Value
12767,1,949.82,375,2,1,3,6,Other
12768,1,168.69,450,1,1,1,3,At-Risk
12769,1,1143.6,238,2,1,3,6,Other
12770,2,3246.45,210,2,2,4,8,Other
12771,1,226.29999999999998,485,1,1,1,3,At-Risk
12772,1,752.47,59,3,1,2,6,Other
12773,1,124.25,563,1,1,1,3,At-Risk
12774,1,83.7,535,1,1,1,3,At-Risk
12775,7,1551.1200000000001,16,4,3,3,10,High-Value
12776,1,27.5,667,1,1,1,3,At-Risk
12777,1,519.45,457,1,1,2,4,At-Risk
12778,9,1541.68,19,4,4,3,11,High-Value
12779,14,6474.11,37,3,4,4,11,High-Value
12780,1,322.4,598,1,1,1,3,At-Risk
12781,2,786.74,63,3,2,2,7,Other
12782,11,3862.2400000000002,4,4,4,4,12,High-Value
12783,4,1295.8700000000001,1,4,3,3,10,High-Value
12784,2,1511.15,14,4,2,3,9,High-Value
12785,3,904.4,363,2,2,3,7,Other
12786,1,668.5,609,1,1,2,4,At-Risk
12787,4,799.1800000000001,9,4,3,2,9,High-Value
12788,4,384.90000000000003,462,1,3,2,6,At-Risk
12789,3,225.35,64,3,2,1,6,Other
12790,2,546.85,191,2,2,2,6,Other
12791,5,656.83,373,2,3,2,7,Other
12792,2,715.01,256,2,2,2,6,Other
12793,3,745.53,334,2,2,2,6,Other
12794,2,860.41,52,3,2,3,8,Other
12795,1,318.48,18,4,1,1,6,One-Time
12796,1,351.0,627,1,1,2,4,At-Risk
12797,2,468.08000000000004,365,2,2,2,6,Other
12798,4,8510.93,9,4,3,4,11,High-Value
12799,1,219.35,528,1,1,1,3,At-Risk
12800,2,500.25,469,1,2,2,5,At-Risk
12801,1,871.82,500,1,1,3,5,At-Risk
12802,5,2186.42,186,2,3,3,8,Other
12803,1,1017.81,392,1,1,3,5,At-Risk
12804,2,325.37,465,1,2,1,4,At-Risk
12805,4,1230.95,381,1,3,3,7,At-Risk
12806,2,2558.96,571,1,2,4,7,At-Risk
12807,1,250.35,382,1,1,1,3,At-Risk
12808,5,748.7,36,3,3,2,8,Loyal
12809,3,1384.34,177,2,2,3,7,Other
12810,2,534.99,534,1,2,2,5,At-Risk
12811,4,893.9,261,2,3,3,8,Other
12812,1,229.64000000000001,44,3,1,1,5,One-Time
12813,3,1621.8,501,1,2,3,6,At-Risk
12814,1,85.92,101,2,1,1,4,One-Time
12815,2,863.46,147,2,2,3,7,Other
12816,2,452.2,95,2,2,2,6,Other
12817,3,570.98,280,2,2,2,6,Other
12818,1,1182.0800000000002,261,2,1,3,6,Other
12819,1,540.52,457,1,1,2,4,At-Risk
12820,11,2689.52,2,4,4,4,12,High-Value
12821,2,220.8,213,2,2,1,5,Other
12822,2,948.88,70,3,2,3,8,Other
12823,18,6501.5,74,3,4,4,11,High-Value
12824,1,397.12,59,3,1,2,6,Other
12825,2,518.63,520,1,2,2,5,At-Risk
12826,12,2800.75,2,4,4,4,12,High-Value
12827,3,430.15,5,4,2,2,8,Other
12828,6,1018.71,2,4,3,3,10,High-Value
12829,3,385.3,336,2,2,2,6,Other
12830,6,6814.64,37,3,3,4,10,High-Value
12831,3,451.11,261,2,2,2,6,Other
12832,2,383.03000000000003,31,3,2,2,7,Other
12833,1,417.38,144,2,1,2,5,Other
12834,1,312.38,282,2,1,1,4,One-Time
12835,41,5996.83,427,1,4,4,9,High-Value
12836,15,6559.7300000000005,58,3,4,4,11,High-Value
12837,2,662.66,172,2,2,2,6,Other
12838,10,2975.91,33,3,4,4,11,High-Value
12839,26,9669.12,2,4,4,4,12,High-Value
12840,7,4041.9700000000003,143,2,3,4,9,High-Value
12841,40,6958.2,4,4,4,4,12,High-Value
12842,4,1917.99,69,3,3,3,9,High-Value
12843,28,6461.87,65,3,4,4,11,High-Value
12844,4,648.6,28,3,3,2,8,Loyal
12845,4,354.09000000000003,266,2,3,2,7,Other
12847,2,1609.0,21,4,2,3,9,High-Value
12848,1,208.0,675,1,1,1,3,At-Risk
12849,6,3015.98,30,3,3,4,10,High-Value
12850,1,330.0,445,1,1,1,3,At-Risk
12851,2,280.76,96,2,2,1,5,Other
12852,1,311.55,294,2,1,1,4,One-Time
12853,11,3907.5,134,2,4,4,10,High-Value
12854,7,2970.9700000000003,78,3,3,4,10,High-Value
12855,4,612.84,372,2,3,2,7,Other
12856,6,2170.78,7,4,3,3,10,High-Value
12857,6,3688.0,210,2,3,4,9,High-Value
12858,1,147.27,382,1,1,1,3,At-Risk
12859,1,575.1,458,1,1,2,4,At-Risk
12860,1,54.22,692,1,1,1,3,At-Risk
12861,1,68.25,619,1,1,1,3,At-Risk
12862,2,984.62,425,1,2,3,6,At-Risk
12863,6,2792.55,51,3,3,4,10,High-Value
12864,2,299.57,137,2,2,1,5,Other
12865,4,3323.4700000000003,25,3,3,4,10,High-Value
12866,3,1092.35,282,2,2,3,7,Other
12867,13,7829.26,25,3,4,4,11,High-Value
12868,8,2043.76,185,2,4,3,9,High-Value
12869,1,337.67,681,1,1,1,3,At-Risk
12870,3,1676.95,374,2,2,3,7,Other
12871,3,744.02,83,3,2,2,7,Other
12872,12,3283.96,326,2,4,4,10,High-Value
12873,3,2027.3,281,2,2,3,7,Other
12874,2,873.42,384,1,2,3,6,At-Risk
12875,5,1356.9900000000002,142,2,3,3,8,Other
12876,4,3751.79,57,3,3,4,10,High-Value
12877,20,2942.1400000000003,3,4,4,4,12,High-Value
12878,2,854.99,235,2,2,2,6,Other
12879,3,573.22,44,3,2,2,7,Other
12880,2,640.13,381,1,2,2,5,At-Risk
12881,1,298.0,275,2,1,1,4,One-Time
12882,2,1463.04,8,4,2,3,9,High-Value
12883,4,703.47,24,4,3,2,9,High-Value
12884,1,309.05,87,3,1,1,5,One-Time
12885,3,1175.22,62,3,2,3,8,Other
12886,2,1378.4,67,3,2,3,8,Other
12887,1,222.4,383,1,1,1,3,At-Risk
12888,2,354.12,213,2,2,2,6,Other
12889,4,385.46000000000004,380,1,3,2,6,At-Risk
12890,2,706.02,23,4,2,2,8,Other
12891,11,840.5,185,2,4,2,8,Other
12892,1,263.38,396,1,1,1,3,At-Risk
12893,1,176.55,30,3,1,1,5,One-Time
12894,1,157.35,574,1,1,1,3,At-Risk
12895,2,372.8,41,3,2,2,7,Other
12897,4,514.25,204,2,3,2,7,Other
12898,2,296.21,463,1,2,1,4,At-Risk
12899,1,366.4,413,1,1,2,4,At-Risk
12900,1,340.33000000000004,421,1,1,2,4,At-Risk
12901,28,17654.54,8,4,4,4,12,High-Value
12902,1,138.68,264,2,1,1,4,One-Time
12903,1,833.5300000000001,428,1,1,2,4,At-Risk
12904,2,496.06,17,4,2,2,8,Other
12905,2,1018.42,576,1,2,3,6,At-Risk
12906,5,2919.81,11,4,3,4,11,High-Value
12907,2,508.91,395,1,2,2,5,At-Risk
12908,5,1776.0,175,2,3,3,8,Other
12909,8,3103.19,39,3,4,4,11,High-Value
12910,13,5796.52,22,4,4,4,12,High-Value
12911,1,1651.72,551,1,1,3,5,At-Risk
12912,5,1662.3000000000002,2,4,3,3,10,High-Value
12913,13,6283.24,4,4,4,4,12,High-Value
12914,1,223.98,400,1,1,1,3,At-Risk
12915,4,975.1,148,2,3,3,8,Other
12916,7,4479.73,138,2,3,4,9,High-Value
12917,6,4359.2,127,2,3,4,9,High-Value
12919,6,1335.19,7,4,3,3,10,High-Value
12920,4,486.64,16,4,3,2,9,High-Value
12921,74,35233.24,8,4,4,4,12,High-Value
12922,1,405.38,160,2,1,2,5,Other
12923,3,769.17,63,3,2,2,7,Other
12924,12,2461.4500000000003,87,3,4,4,11,High-Value
12925,3,729.33,4,4,2,2,8,Other
12926,4,1523.59,410,1,3,3,7,At-Risk
12927,1,197.31,394,1,1,1,3,At-Risk
12928,12,4304.89,34,3,4,4,11,High-Value
12929,1,117.85,311,2,1,1,4,One-Time
12930,2,415.8,77,3,2,2,7,Other
12931,57,92347.34,21,4,4,4,12,High-Value
12932,8,1698.56,538,1,4,3,8,At-Risk
12933,8,1636.6299999999999,23,4,4,3,11,High-Value
12934,1,181.65,736,1,1,1,3,At-Risk
12935,15,4243.86,1,4,4,4,12,High-Value
12936,4,1063.9,16,4,3,3,10,High-Value
12937,9,3097.61,14,4,4,4,12,High-Value
12938,1,114.14,25,3,1,1,5,One-Time
12939,20,25264.8,63,3,4,4,11,High-Value
12940,2,899.6899999999999,54,3,2,3,8,Other
12941,1,377.49,723,1,1,2,4,At-Risk
12942,3,675.6,130,2,2,2,6,Other
12943,2,496.5,557,1,2,2,5,At-Risk
12944,2,604.51,35,3,2,2,7,Other
12945,2,900.11,287,2,2,3,7,Other
12946,1,324.45,436,1,1,1,3,At-Risk
12947,6,1603.99,143,2,3,3,8,Other
12948,9,2317.43,15,4,4,4,12,High-Value
12949,22,15526.7,30,3,4,4,11,High-Value
12950,3,1843.0,1,4,2,3,9,High-Value
12951,15,3213.7200000000003,8,4,4,4,12,High-Value
12952,4,1387.79,5,4,3,3,10,High-Value
12953,2,828.8100000000001,9,4,2,2,8,Other
12954,1,162.45,638,1,1,1,3,At-Risk
12955,11,4757.16,0,4,4,4,12,High-Value
12956,4,521.89,305,2,3,2,7,Other
12957,13,8706.97,9,4,4,4,12,High-Value
12958,2,467.34000000000003,399,1,2,2,5,At-Risk
12959,1,150.95,483,1,1,1,3,At-Risk
12960,4,1322.0700000000002,413,1,3,3,7,At-Risk
12961,1,211.98999999999998,378,2,1,1,4,One-Time
12962,2,266.39,6,4,2,1,7,Other
12963,12,3235.79,7,4,4,4,12,High-Value
12964,1,132.24,436,1,1,1,3,At-Risk
12965,1,769.8100000000001,88,3,1,2,6,Other
12966,1,160.18,9,4,1,1,6,One-Time
12967,3,2938.52,357,2,2,4,8,Other
12968,1,135.95,111,2,1,1,4,One-Time
12969,1,122.45,602,1,1,1,3,At-Risk
12970,10,1452.54,6,4,4,3,11,High-Value
12971,116,15704.6,3,4,4,4,12,High-Value
12972,4,1161.2,413,1,3,3,7,At-Risk
12973,1,385.55,413,1,1,2,4,At-Risk
12974,2,408.95,197,2,2,2,6,Other
12975,6,2100.09,436,1,3,3,7,At-Risk
12976,8,3156.38,211,2,4,4,10,High-Value
12977,4,513.88,155,2,3,2,7,Other
12978,5,2502.82,384,1,3,4,8,At-Risk
12979,1,517.7,728,1,1,2,4,At-Risk
12980,21,16245.78,157,2,4,4,10,High-Value
12981,2,372.21999999999997,29,3,2,2,7,Other
12982,8,2744.81,242,2,4,4,10,High-Value
12983,1,490.08,597,1,1,2,4,At-Risk
12984,1,97.5,18,4,1,1,6,One-Time
12985,2,1239.38,0,4,2,3,9,High-Value
12986,10,2729.84,428,1,4,4,9,High-Value
12987,5,1312.21,73,3,3,3,9,High-Value
12988,1,505.82,291,2,1,2,5,Other
12989,33,13551.75,2,4,4,4,12,High-Value
12990,7,955.5,30,3,3,3,9,High-Value
12991,3,764.82,22,4,2,2,8,Other
12992,1,93.35,724,1,1,1,3,At-Risk
12993,8,1259.63,22,4,4,3,11,High-Value
12994,3,974.42,3,4,2,3,9,High-Value
12995,1,211.32,84,3,1,1,5,One-Time
12996,1,355.5,375,2,1,2,5,Other
12997,8,2110.91,21,4,4,3,11,High-Value
12998,3,920.08,492,1,2,3,6,At-Risk
12999,3,455.88,195,2,2,2,6,Other
13000,4,1032.5,106,2,3,3,8,Other
13001,33,24042.65,3,4,4,4,12,High-Value
13002,3,414.13,317,2,2,2,6,Other
13003,3,149.05,105,2,2,1,5,Other
13004,36,11650.85,11,4,4,4,12,High-Value
13005,4,999.68,173,2,3,3,8,Other
13006,1,81.57,55,3,1,1,5,One-Time
13007,1,175.25,579,1,1,1,3,At-Risk
13008,3,612.13,322,2,2,2,6,Other
13009,1,234.0,672,1,1,1,3,At-Risk
13010,2,330.12,373,2,2,1,5,Other
13011,1,50.550000000000004,371,2,1,1,4,One-Time
13012,11,2957.83,8,4,4,4,12,High-Value
13013,29,11097.43,0,4,4,4,12,High-Value
13014,11,5381.08,10,4,4,4,12,High-Value
13015,11,6579.78,52,3,4,4,11,High-Value
13016,3,789.89,72,3,2,2,7,Other
13017,1,204.0,6,4,1,1,6,One-Time
13018,35,9763.16,15,4,4,4,12,High-Value
13019,6,1229.95,378,2,3,3,8,Other
13020,2,618.96,562,1,2,2,5,At-Risk
13021,17,4887.24,3,4,4,4,12,High-Value
13022,1,50.3,429,1,1,1,3,At-Risk
13023,3,1251.03,63,3,2,3,8,Other
13024,2,555.87,470,1,2,2,5,At-Risk
13025,1,323.39,731,1,1,1,3,At-Risk
13026,9,1733.08,0,4,4,3,11,High-Value
13027,19,17239.2,113,2,4,4,10,High-Value
13028,2,661.3199999999999,22,4,2,2,8,Other
13029,5,1927.3,30,3,3,3,9,High-Value
13030,2,752.44,10,4,2,2,8,Other
13031,5,3292.84,406,1,3,4,8,At-Risk
13032,9,2815.96,51,3,4,4,11,High-Value
13033,2,220.55,356,2,2,1,5,Other
13034,3,756.82,54,3,2,2,7,Other
13035,3,1364.2,73,3,2,3,8,Other
13036,1,307.1,684,1,1,1,3,At-Risk
13037,12,3914.9500000000003,137,2,4,4,10,High-Value
13038,3,908.46,79,3,2,3,8,Other
13039,4,1010.73,583,1,3,3,7,At-Risk
13040,2,676.99,8,4,2,2,8,Other
13041,4,799.13,450,1,3,2,6,At-Risk
13042,3,1488.59,597,1,2,3,6,At-Risk
13043,1,516.42,272,2,1,2,5,Other
13044,11,4848.05,290,2,4,4,10,High-Value
13045,3,808.9200000000001,98,2,2,2,6,Other
13046,3,949.25,30,3,2,3,8,Other
13047,23,8423.58,56,3,4,4,11,High-Value
13048,9,4049.13,13,4,4,4,12,High-Value
13049,4,1408.24,63,3,3,3,9,High-Value
13050,34,11877.29,14,4,4,4,12,High-Value
13051,2,155.8,578,1,2,1,4,At-Risk
13052,7,3118.48,211,2,3,4,9,High-Value
13053,1,127.65,621,1,1,1,3,At-Risk
13055,4,2321.11,77,3,3,4,10,High-Value
13056,1,209.48000000000002,550,1,1,1,3,At-Risk
13057,3,709.59,529,1,2,2,5,At-Risk
13058,3,271.4,24,4,2,1,7,Other
13059,10,2291.77,249,2,4,4,10,High-Value
13060,1,307.53000000000003,253,2,1,1,4,One-Time
13061,1,248.60999999999999,71,3,1,1,5,One-Time
13062,1,346.98,190,2,1,2,5,Other
13063,1,188.4,480,1,1,1,3,At-Risk
13064,6,1666.84,12,4,3,3,10,High-Value
13065,5,1055.05,372,2,3,3,8,Other
13066,2,470.8,23,4,2,2,8,Other
13067,3,508.51,81,3,2,2,7,Other
13068,2,344.0,9,4,2,2,8,Other
13069,38,9284.45,0,4,4,4,12,High-Value
13070,4,751.7,191,2,3,2,7,Other
13071,1,129.22,611,1,1,1,3,At-Risk
13072,1,177.15,266,2,1,1,4,One-Time
13073,2,418.08,410,1,2,2,5,At-Risk
13074,4,1378.74,510,1,3,3,7,At-Risk
13075,1,919.61,129,2,1,3,6,Other
13076,1,135.4,457,1,1,1,3,At-Risk
13077,11,2740.65,0,4,4,4,12,High-Value
13078,57,29018.06,2,4,4,4,12,High-Value
13079,6,419.18,3,4,3,2,9,High-Value
13080,4,280.73,178,2,3,1,6,Other
13081,28,56838.37,11,4,4,4,12,High-Value
13082,21,7335.75,125,2,4,4,10,High-Value
13083,3,395.43,3,4,2,2,8,Other
13084,1,122.39999999999999,491,1,1,1,3,At-Risk
13085,8,2433.28,157,2,4,4,10,High-Value
13086,1,439.33000000000004,382,1,1,2,4,At-Risk
13087,1,313.64,725,1,1,1,3,At-Risk
13088,1,236.11,416,1,1,1,3,At-Risk
13089,203,113416.91,2,4,4,4,12,High-Value
13090,23,13076.74,8,4,4,4,12,High-Value
13091,2,1108.8,27,3,2,3,8,Other
13092,12,2140.28,70,3,4,3,10,High-Value
13093,55,54144.25,275,2,4,4,10,High-Value
13094,13,2209.44,20,4,4,3,11,High-Value
13095,1,74.39999999999999,70,3,1,1,5,One-Time
13096,1,419.7000000000001,393,1,1,2,4,At-Risk
13097,27,13015.36,32,3,4,4,11,High-Value
13098,28,28882.44,0,4,4,4,12,High-Value
13099,1,207.36,98,2,1,1,4,One-Time
13101,4,695.4,233,2,3,2,7,Other
13102,37,11380.1,0,4,4,4,12,High-Value
13103,3,709.64,39,3,2,2,7,Other
13104,9,1709.1,2,4,4,3,11,High-Value
13105,1,72.0,435,1,1,1,3,At-Risk
13106,2,603.46,132,2,2,2,6,Other
13107,9,5253.07,43,3,4,4,11,High-Value
13108,2,748.46,372,2,2,2,6,Other
13109,3,1134.03,59,3,2,3,8,Other
13110,12,2957.4700000000003,30,3,4,4,11,High-Value
13111,1,321.88,718,1,1,1,3,At-Risk
13112,1,20.599999999999998,540,1,1,1,3,At-Risk
13113,37,18230.07,0,4,4,4,12,High-Value
13114,1,234.38,730,1,1,1,3,At-Risk
13115,10,5494.7,11,4,4,4,12,High-Value
13116,1,501.14,137,2,1,2,5,Other
13117,18,2255.66,21,4,4,4,12,High-Value
13118,9,2415.41,19,4,4,4,12,High-Value
13119,1,134.9,668,1,1,1,3,At-Risk
13120,1,30.6,238,2,1,1,4,One-Time
13121,1,283.73,268,2,1,1,4,One-Time
13122,2,922.39,93,3,2,3,8,Other
13123,2,506.75,472,1,2,2,5,At-Risk
13124,4,4641.66,89,3,3,4,10,High-Value
13125,1,148.62,523,1,1,1,3,At-Risk
13126,13,3774.81,4,4,4,4,12,High-Value
13127,1,259.17,77,3,1,1,5,One-Time
13128,1,263.5,630,1,1,1,3,At-Risk
13129,2,233.25,451,1,2,1,4,At-Risk
13130,1,64.0,93,3,1,1,5,One-Time
13131,7,3313.77,22,4,3,4,11,High-Value
13132,1,77.3,261,2,1,1,4,One-Time
13133,3,200.45,273,2,2,1,5,Other
13134,6,2475.23,85,3,3,4,10,High-Value
13135,2,3371.45,196,2,2,4,8,Other
13136,13,6274.56,55,3,4,4,11,High-Value
13137,16,7586.94,10,4,4,4,12,High-Value
13138,7,1274.01,21,4,3,3,10,High-Value
13139,8,8202.98,15,4,4,4,12,High-Value
13140,5,1054.92,107,2,3,3,8,Other
13141,17,7656.08,84,3,4,4,11,High-Value
13142,1,307.09000000000003,18,4,1,1,6,One-Time
13143,1,405.1,584,1,1,2,4,At-Risk
13144,2,135.35,332,2,2,1,5,Other
13145,7,1128.52,39,3,3,3,9,High-Value
13146,1,228.91,25,3,1,1,5,One-Time
13147,4,712.8,9,4,3,2,9,High-Value
13148,26,8488.32,28,3,4,4,11,High-Value
13149,4,1676.06,13,4,3,3,10,High-Value
13150,3,449.96999999999997,483,1,2,2,5,At-Risk
13151,3,2454.71,295,2,2,4,8,Other
13152,7,2146.38,416,1,3,3,7,At-Risk
13153,1,486.22,5,4,1,2,7,Other
13154,3,1624.84,398,1,2,3,6,At-Risk
13155,6,1370.48,32,3,3,3,9,High-Value
13156,3,1586.54,384,1,2,3,6,At-Risk
13157,9,5687.36,48,3,4,4,11,High-Value
13158,5,1508.18,94,3,3,3,9,High-Value
13159,4,1429.35,8,4,3,3,10,High-Value
13160,1,91.8,21,4,1,1,6,One-Time
13161,2,472.13,312,2,2,2,6,Other
13162,16,9275.49,121,2,4,4,10,High-Value
13163,1,17.65,609,1,1,1,3,At-Risk
13164,2,372.2,568,1,2,2,5,At-Risk
13165,3,1451.1599999999999,45,3,2,3,8,Other
13166,2,875.93,282,2,2,3,7,Other
13167,5,1113.15,18,4,3,3,10,High-Value
13168,5,1840.73,35,3,3,3,9,High-Value
13169,3,840.08,63,3,2,2,7,Other
13170,1,108.81,26,3,1,1,5,One-Time
13171,3,468.40999999999997,21,4,2,2,8,Other
13172,1,69.6,399,1,1,1,3,At-Risk
13173,11,2389.82,3,4,4,4,12,High-Value
13174,11,7972.46,15,4,4,4,12,High-Value
13175,2,831.45,581,1,2,2,5,At-Risk
13176,1,481.49,45,3,1,2,6,Other
13177,2,512.2,64,3,2,2,7,Other
13178,21,14059.19,25,3,4,4,11,High-Value
13179,1,572.3100000000001,618,1,1,2,4,At-Risk
13180,1,86.1,606,1,1,1,3,At-Risk
13181,1,359.69,380,1,1,2,4,At-Risk
13182,1,121.18,44,3,1,1,5,One-Time
13183,15,7036.18,7,4,4,4,12,High-Value
13184,10,1667.95,14,4,4,3,11,High-Value
13185,1,71.4,267,2,1,1,4,One-Time
13186,3,1575.89,39,3,2,3,8,Other
13187,4,328.36,336,2,3,1,6,Other
13188,1,114.6,10,4,1,1,6,One-Time
13189,2,260.68,18,4,2,1,7,Other
13190,3,570.66,543,1,2,2,5,At-Risk
13191,1,159.21,657,1,1,1,3,At-Risk
13192,6,2558.58,94,3,3,4,10,High-Value
13193,1,112.08,60,3,1,1,5,One-Time
13194,2,472.78000000000003,135,2,2,2,6,Other
13195,1,136.73,413,1,1,1,3,At-Risk
13196,7,3068.84,10,4,3,4,11,High-Value
13197,1,373.01000000000005,609,1,1,2,4,At-Risk
13198,8,4974.2300000000005,9,4,4,4,12,High-Value
13199,66,15949.210000000001,3,4,4,4,12,High-Value
13200,4,870.09,18,4,3,3,10,High-Value
13201,4,1233.06,501,1,3,3,7,At-Risk
13202,7,1580.3,393,1,3,3,7,At-Risk
13203,10,2648.25,9,4,4,4,12,High-Value
13204,1,966.6600000000001,730,1,1,3,5,At-Risk
13205,1,2803.2,442,1,1,4,6,At-Risk
13206,13,8308.19,399,1,4,4,9,High-Value
13207,4,535.86,14,4,3,2,9,High-Value
13208,8,1951.82,58,3,4,3,10,High-Value
13209,13,8509.51,29,3,4,4,11,High-Value
13210,1,353.48,93,3,1,2,6,Other
13211,10,2618.77,9,4,4,4,12,High-Value
13212,3,786.83,19,4,2,2,8,Other
13213,11,3851.52,56,3,4,4,11,High-Value
13214,7,3264.23,417,1,3,4,8,At-Risk
13215,1,81.6,401,1,1,1,3,At-Risk
13216,1,333.74,267,2,1,1,4,One-Time
13217,4,666.48,121,2,3,2,7,Other
13218,1,62.64,126,2,1,1,4,One-Time
13219,1,76.23,617,1,1,1,3,At-Risk
13220,5,1336.0900000000001,77,3,3,3,9,High-Value
13221,2,844.86,239,2,2,2,6,Other
13222,1,88.5,576,1,1,1,3,At-Risk
13223,6,969.12,199,2,3,3,8,Other
13224,2,2152.95,59,3,2,3,8,Other
13225,16,16260.07,2,4,4,4,12,High-Value
13226,2,312.46,272,2,2,1,5,Other
13227,1,257.7,201,2,1,1,4,One-Time
13228,1,358.0,80,3,1,2,6,Other
13229,1,160.95,225,2,1,1,4,One-Time
13230,30,6109.51,3,4,4,4,12,High-Value
13232,7,1327.75,12,4,3,3,10,High-Value
13233,4,1176.46,73,3,3,3,9,High-Value
13234,2,346.5,672,1,2,2,5,At-Risk
13235,1,1031.07,211,2,1,3,6,Other
13236,2,744.85,24,4,2,2,8,Other
13237,1,643.0,387,1,1,2,4,At-Risk
13238,6,1006.63,16,4,3,3,10,High-Value
13239,5,1594.69,261,2,3,3,8,Other
13240,8,1455.39,95,2,4,3,9,High-Value
13241,1,112.53,411,1,1,1,3,At-Risk
13242,7,699.4,111,2,3,2,7,Other
13243,5,1220.38,202,2,3,3,8,Other
13244,1,121.74,92,3,1,1,5,One-Time
13245,2,989.22,50,3,2,3,8,Other
13246,11,3351.75,17,4,4,4,12,High-Value
13247,4,501.12,17,4,3,2,9,High-Value
13248,2,465.68,124,2,2,2,6,Other
13249,9,1608.9299999999998,91,3,4,3,10,High-Value
13250,2,253.09,460,1,2,1,4,At-Risk
13251,1,252.68,401,1,1,1,3,At-Risk
13252,2,399.3,393,1,2,2,5,At-Risk
13253,4,2951.11,156,2,3,4,9,High-Value
13254,1,51.410000000000004,375,2,1,1,4,One-Time
13255,3,678.76,8,4,2,2,8,Other
13257,1,149.75,435,1,1,1,3,At-Risk
13258,5,1009.43,11,4,3,3,10,High-Value
13259,9,1398.79,61,3,4,3,10,High-Value
13260,1,557.62,60,3,1,2,6,Other
13261,2,944.1,268,2,2,3,7,Other
13262,3,573.45,262,2,2,2,6,Other
13263,38,8650.98,0,4,4,4,12,High-Value
13264,1,722.5600000000001,442,1,1,2,4,At-Risk
13265,5,2092.66,52,3,3,3,9,High-Value
13266,19,6135.04,10,4,4,4,12,High-Value
13267,36,9429.81,2,4,4,4,12,High-Value
13268,10,3152.71,17,4,4,4,12,High-Value
13269,28,8537.32,0,4,4,4,12,High-Value
13270,1,590.0,365,2,1,2,5,Other
13271,1,211.49,36,3,1,1,5,One-Time
13272,2,276.56,30,3,2,1,6,Other
13273,1,138.98,112,2,1,1,4,One-Time
13274,1,360.85,408,1,1,2,4,At-Risk
13275,2,238.86,383,1,2,1,4,At-Risk
13276,5,1891.91,63,3,3,3,9,High-Value
13277,7,523.3,15,4,3,2,9,High-Value
13278,4,1425.35,40,3,3,3,9,High-Value
13279,1,137.75,77,3,1,1,5,One-Time
13280,7,2293.33,121,2,3,4,9,High-Value
13281,1,350.85,438,1,1,2,4,At-Risk
13282,4,1313.19,17,4,3,3,10,High-Value
13283,4,373.36,59,3,3,2,8,Loyal
13284,1,201.19,330,2,1,1,4,One-Time
13285,6,3364.59,22,4,3,4,11,High-Value
13286,1,734.91,599,1,1,2,4,At-Risk
13287,3,781.59,602,1,2,2,5,At-Risk
13288,5,927.61,442,1,3,3,7,At-Risk
13289,1,307.95,723,1,1,1,3,At-Risk
13291,11,3270.79,155,2,4,4,10,High-Value
13292,5,994.51,38,3,3,3,9,High-Value
13293,6,1192.94,391,1,3,3,7,At-Risk
13294,3,1689.53,189,2,2,3,7,Other
13295,4,1101.97,359,2,3,3,8,Other
13296,6,792.51,136,2,3,2,7,Other
13297,7,4368.62,7,4,3,4,11,High-Value
13298,1,360.0,0,4,1,2,7,Other
13299,3,1218.7,267,2,2,3,7,Other
13300,3,1285.51,168,2,2,3,7,Other
13301,4,600.1899999999999,103,2,3,2,7,Other
13302,2,159.2,154,2,2,1,5,Other
13303,1,61.72,399,1,1,1,3,At-Risk
13304,4,1217.99,350,2,3,3,8,Other
13305,16,3616.41,3,4,4,4,12,High-Value
13306,1,53.65,429,1,1,1,3,At-Risk
13307,3,273.34,119,2,2,1,5,Other
13308,4,1670.3700000000001,22,4,3,3,10,High-Value
13309,6,1706.3700000000001,6,4,3,3,10,High-Value
13310,5,1541.2,27,3,3,3,9,High-Value
13311,2,598.57,3,4,2,2,8,Other
13312,1,124.75,450,1,1,1,3,At-Risk
13313,12,3445.32,21,4,4,4,12,High-Value
13314,3,775.94,1,4,2,2,8,Other
13315,1,310.26,688,1,1,1,3,At-Risk
13316,10,12940.82,36,3,4,4,11,High-Value
13317,19,6486.091,65,3,4,4,11,High-Value
13318,3,640.76,0,4,2,2,8,Other
13319,58,21323.22,4,4,4,4,12,High-Value
13320,6,2211.6,77,3,3,3,9,High-Value
13321,2,567.36,71,3,2,2,7,Other
13322,1,199.48000000000002,16,4,1,1,6,One-Time
13323,5,787.85,2,4,3,2,9,High-Value
13324,18,10513.47,35,3,4,4,11,High-Value
13325,1,675.3,81,3,1,2,6,Other
13326,1,281.76000000000005,431,1,1,1,3,At-Risk
13327,19,9052.87,38,3,4,4,11,High-Value
13328,1,1308.48,315,2,1,3,6,Other
13329,8,4808.7699999999995,31,3,4,4,11,High-Value
13330,6,2796.1,92,3,3,4,10,High-Value
13331,1,262.40000000000003,401,1,1,1,3,At-Risk
13332,1,350.90000000000003,13,4,1,2,7,Other
13333,3,1015.74,410,1,2,3,6,At-Risk
13334,5,6201.8,81,3,3,4,10,High-Value
13336,1,795.12,76,3,1,2,6,Other
13337,1,1575.26,545,1,1,3,5,At-Risk
13338,4,2345.62,157,2,3,4,9,High-Value
13339,1,860.12,200,2,1,3,6,Other
13340,12,22100.56,44,3,4,4,11,High-Value
13341,1,775.85,260,2,1,2,5,Other
13343,1,303.43,177,2,1,1,4,One-Time
13344,3,2511.69,67,3,2,4,9,High-Value
13345,1,339.5,287,2,1,1,4,One-Time
13346,6,299.4,462,1,3,1,5,At-Risk
13347,1,291.36,69,3,1,1,5,One-Time
13348,1,233.76000000000002,63,3,1,1,5,One-Time
13349,1,197.32,10,4,1,1,6,One-Time
13350,2,879.12,15,4,2,3,9,High-Value
13351,1,323.94,65,3,1,1,5,One-Time
13352,1,347.98,59,3,1,2,6,Other
13354,1,743.53,70,3,1,2,6,Other
13355,1,674.7,121,2,1,2,5,Other
13356,1,768.24,79,3,1,2,6,Other
13357,5,3795.01,256,2,3,4,9,High-Value
13358,1,389.03,268,2,1,2,5,Other
13359,2,943.3100000000001,63,3,2,3,8,Other
13360,4,1503.65,431,1,3,3,7,At-Risk
13361,2,1450.5,471,1,2,3,6,At-Risk
13362,7,5394.07,8,4,3,4,11,High-Value
13363,3,1623.8600000000001,17,4,2,3,9,High-Value
13364,1,134.96,70,3,1,1,5,One-Time
13365,2,2225.37,33,3,2,3,8,Other
13366,1,56.16,49,3,1,1,5,One-Time
13367,1,460.2,431,1,1,2,4,At-Risk
13368,4,1021.5,256,2,3,3,8,Other
13369,1,258.28000000000003,365,2,1,1,4,One-Time
13370,1,754.87,371,2,1,2,5,Other
13371,2,2297.66,504,1,2,4,7,At-Risk
13372,1,328.64,89,3,1,1,5,One-Time
13373,6,7587.1900000000005,60,3,3,4,10,High-Value
13374,2,372.8,414,1,2,2,5,At-Risk
13375,2,1792.23,88,3,2,3,8,Other
13376,3,869.76,98,2,2,3,7,Other
13377,2,1452.88,396,1,2,3,6,At-Risk
13379,3,572.56,25,3,2,2,7,Other
13380,1,62.4,432,1,1,1,3,At-Risk
13381,12,8224.37,31,3,4,4,11,High-Value
13382,5,1387.58,280,2,3,3,8,Other
13383,1,305.28000000000003,543,1,1,1,3,At-Risk
13384,11,6680.83,30,3,4,4,11,High-Value
13385,1,534.57,329,2,1,2,5,Other
13386,2,835.46,413,1,2,2,5,At-Risk
13387,1,181.84,416,1,1,1,3,At-Risk
13388,3,1185.65,130,2,2,3,7,Other
13389,3,797.96,10,4,2,2,8,Other
13390,1,544.08,74,3,1,2,6,Other
13391,1,59.8,203,2,1,1,4,One-Time
13392,1,91.14,676,1,1,1,3,At-Risk
13393,4,1131.45,583,1,3,3,7,At-Risk
13394,19,6621.7,1,4,4,4,12,High-Value
13395,3,1180.23,184,2,2,3,7,Other
13396,2,1360.99,28,3,2,3,8,Other
13397,10,3191.87,72,3,4,4,11,High-Value
13398,2,670.34,191,2,2,2,6,Other
13399,3,275.4,463,1,2,1,4,At-Risk
13400,1,310.83,582,1,1,1,3,At-Risk
13402,4,1226.8500000000001,126,2,3,3,8,Other
13403,3,229.5,17,4,2,1,7,Other
13404,2,252.49,0,4,2,1,7,Other
13405,5,1198.81,203,2,3,3,8,Other
13406,2,568.92,426,1,2,2,5,At-Risk
13407,3,2244.7,578,1,2,4,7,At-Risk
13408,106,50174.782,1,4,4,4,12,High-Value
13410,9,2201.96,23,4,4,3,11,High-Value
13411,1,213.55,106,2,1,1,4,One-Time
13412,1,487.35,619,1,1,2,4,At-Risk
13413,6,429.44,639,1,3,2,6,At-Risk
13414,6,2494.14,133,2,3,4,9,High-Value
13415,4,784.17,472,1,3,2,6,At-Risk
13416,3,940.8000000000001,43,3,2,3,8,Other
13417,6,1669.49,4,4,3,3,10,High-Value
13418,31,11559.66,11,4,4,4,12,High-Value
13419,1,221.06,63,3,1,1,5,One-Time
13420,2,159.85,149,2,2,1,5,Other
13421,8,4048.25,39,3,4,4,11,High-Value
13422,1,2626.3,63,3,1,4,8,Other
13423,1,217.03,428,1,1,1,3,At-Risk
13424,1,572.77,449,1,1,2,4,At-Risk
13425,5,3390.4300000000003,107,2,3,4,9,High-Value
13426,22,8167.38,0,4,4,4,12,High-Value
13427,6,1006.53,18,4,3,3,10,High-Value
13428,3,478.54,9,4,2,2,8,Other
13429,4,1006.8,10,4,3,3,10,High-Value
13430,2,679.45,18,4,2,2,8,Other
13431,8,3316.2400000000002,66,3,4,4,11,High-Value
13432,2,436.55,570,1,2,2,5,At-Risk
13433,4,658.32,500,1,3,2,6,At-Risk
13434,5,1666.8600000000001,73,3,3,3,9,High-Value
13435,9,4447.33,4,4,4,4,12,High-Value
13436,1,196.89,1,4,1,1,6,One-Time
13437,7,3408.06,13,4,3,4,11,High-Value
13438,1,46.5,546,1,1,1,3,At-Risk
13439,3,986.61,254,2,2,3,7,Other
13440,7,1295.25,422,1,3,3,7,At-Risk
13441,2,720.9,91,3,2,2,7,Other
13442,3,419.87,666,1,2,2,5,At-Risk
13443,6,1269.3700000000001,448,1,3,3,7,At-Risk
13444,2,619.08,373,2,2,2,6,Other
13445,1,241.89999999999998,625,1,1,1,3,At-Risk
13446,11,3881.89,429,1,4,4,9,High-Value
13447,3,1129.14,22,4,2,3,9,High-Value
13448,12,8386.22,16,4,4,4,12,High-Value
13449,1,291.88,23,4,1,1,6,One-Time
13450,13,4120.04,26,3,4,4,11,High-Value
13451,11,7088.92,25,3,4,4,11,High-Value
13452,3,729.8,258,2,2,2,6,Other
13453,3,781.69,165,2,2,2,6,Other
13454,1,219.87,640,1,1,1,3,At-Risk
13455,6,2212.9900000000002,24,4,3,3,10,High-Value
13456,6,1766.72,17,4,3,3,10,High-Value
13457,2,148.22,688,1,2,1,4,At-Risk
13458,16,11959.27,6,4,4,4,12,High-Value
13459,2,1160.41,624,1,2,3,6,At-Risk
13460,2,183.44,28,3,2,1,6,Other
13461,6,4160.0,38,3,3,4,10,High-Value
13462,5,1153.8500000000001,252,2,3,3,8,Other
13464,6,3097.64,57,3,3,4,10,High-Value
13465,2,931.12,445,1,2,3,6,At-Risk
13466,5,1013.35,183,2,3,3,8,Other
13467,2,1071.91,10,4,2,3,9,High-Value
13468,72,12793.28,1,4,4,4,12,High-Value
13469,1,82.4,652,1,1,1,3,At-Risk
13470,2,165.0,98,2,2,1,5,Other
13471,4,2501.84,0,4,3,4,11,High-Value
13472,2,592.24,463,1,2,2,5,At-Risk
13473,8,2657.7599999999998,60,3,4,4,11,High-Value
13474,3,646.59,235,2,2,2,6,Other
13475,4,1431.78,190,2,3,3,8,Other
13476,5,2061.4700000000003,178,2,3,3,8,Other
13477,11,2819.17,37,3,4,4,11,High-Value
13478,5,2215.78,468,1,3,3,7,At-Risk
13479,4,851.37,200,2,3,2,7,Other
13480,2,627.82,416,1,2,2,5,At-Risk
13481,11,3830.84,45,3,4,4,11,High-Value
13482,2,336.09000000000003,231,2,2,1,5,Other
13483,1,140.34,65,3,1,1,5,One-Time
13484,3,790.72,240,2,2,2,6,Other
13485,11,3015.2200000000003,232,2,4,4,10,High-Value
13486,3,1122.41,77,3,2,3,8,Other
13487,5,846.87,57,3,3,2,8,Loyal
13488,23,14205.960000000001,16,4,4,4,12,High-Value
13489,4,449.52,104,2,3,2,7,Other
13490,1,154.25,653,1,1,1,3,At-Risk
13491,27,4467.66,51,3,4,4,11,High-Value
13492,3,1269.84,135,2,2,3,7,Other
13493,2,498.63,274,2,2,2,6,Other
13494,1,316.26000000000005,311,2,1,1,4,One-Time
13495,10,4863.31,7,4,4,4,12,High-Value
13496,2,653.33,10,4,2,2,8,Other
13497,6,1166.8300000000002,282,2,3,3,8,Other
13498,1,327.38,729,1,1,1,3,At-Risk
13499,5,1159.1100000000001,17,4,3,3,10,High-Value
13500,4,1466.3,22,4,3,3,10,High-Value
13501,3,2885.11,287,2,2,4,8,Other
13502,5,780.5,16,4,3,2,9,High-Value
13503,5,1778.04,70,3,3,3,9,High-Value
13504,1,295.93,63,3,1,1,5,One-Time
13505,4,3633.63,72,3,3,4,10,High-Value
13506,5,1338.08,315,2,3,3,8,Other
13507,4,2479.16,2,4,3,4,11,High-Value
13508,2,287.05,243,2,2,1,5,Other
13509,7,1099.72,8,4,3,3,10,High-Value
13510,11,4558.29,0,4,4,4,12,High-Value
13511,1,282.76,676,1,1,1,3,At-Risk
13512,4,713.39,260,2,3,2,7,Other
13513,3,824.59,126,2,2,2,6,Other
13514,4,815.9000000000001,73,3,3,2,8,Loyal
13515,6,1265.82,72,3,3,3,9,High-Value
13516,4,1685.26,20,4,3,3,10,High-Value
13517,3,2128.42,59,3,2,3,8,Other
13518,1,627.16,85,3,1,2,6,Other
13519,2,343.21,77,3,2,2,7,Other
13520,11,5446.0,58,3,4,4,11,High-Value
13521,3,1070.47,0,4,2,3,9,High-Value
13522,1,125.80000000000001,29,3,1,1,5,One-Time
13523,6,4534.57,32,3,3,4,10,High-Value
13524,5,680.1800000000001,40,3,3,2,8,Loyal
13525,2,628.78,14,4,2,2,8,Other
13526,2,1182.0,737,1,2,3,6,At-Risk
13527,12,4541.29,33,3,4,4,11,High-Value
13529,2,307.76,78,3,2,1,6,Other
13530,1,402.98,633,1,1,2,4,At-Risk
13531,6,1433.07,204,2,3,3,8,Other
13532,1,210.31,33,3,1,1,5,One-Time
13533,3,269.09,182,2,2,1,5,Other
13534,35,7720.900000000001,1,4,4,4,12,High-Value
13535,1,89.5,402,1,1,1,3,At-Risk
13536,7,3444.39,0,4,3,4,11,High-Value
13537,2,717.85,425,1,2,2,5,At-Risk
13538,12,3103.13,42,3,4,4,11,High-Value
13539,7,1569.36,85,3,3,3,9,High-Value
13540,3,632.39,466,1,2,2,5,At-Risk
13541,2,785.25,426,1,2,2,5,At-Risk
13542,17,3959.4900000000002,376,2,4,4,10,High-Value
13543,2,1439.61,633,1,2,3,6,At-Risk
13544,6,790.2,39,3,3,2,8,Loyal
13545,2,364.93,390,1,2,2,5,At-Risk
13546,5,1086.24,11,4,3,3,10,High-Value
13547,1,164.53,407,1,1,1,3,At-Risk
13548,3,901.4399999999999,95,2,2,3,7,Other
13549,8,1005.8000000000001,25,3,4,3,10,High-Value
13550,1,342.55,382,1,1,2,4,At-Risk
13551,2,244.2,318,2,2,1,5,Other
13552,22,6948.92,65,3,4,4,11,High-Value
13553,1,499.6,674,1,1,2,4,At-Risk
13554,7,1629.35,379,1,3,3,7,At-Risk
13555,13,8891.84,73,3,4,4,11,High-Value
13556,2,200.82,428,1,2,1,4,At-Risk
13557,13,3032.26,27,3,4,4,11,High-Value
13558,4,594.52,5,4,3,2,9,High-Value
13559,2,990.0,512,1,2,3,6,At-Risk
13560,1,171.42000000000002,6,4,1,1,6,One-Time
13561,11,1803.4,215,2,4,3,9,High-Value
13562,8,4838.18,81,3,4,4,11,High-Value
13563,2,777.53,83,3,2,2,7,Other
13564,36,15880.22,353,2,4,4,10,High-Value
13565,3,414.8,18,4,2,2,8,Other
13566,5,1684.75,40,3,3,3,9,High-Value
13567,4,1079.29,427,1,3,3,7,At-Risk
13568,1,187.05,172,2,1,1,4,One-Time
13569,4,725.04,16,4,3,2,9,High-Value
13570,1,239.49,242,2,1,1,4,One-Time
13571,26,4537.26,12,4,4,4,12,High-Value
13572,1,1384.25,205,2,1,3,6,Other
13573,6,903.07,49,3,3,3,9,High-Value
13574,1,404.45,410,1,1,2,4,At-Risk
13575,5,732.07,22,4,3,2,9,High-Value
13576,28,11202.59,9,4,4,4,12,High-Value
13577,11,3484.28,24,4,4,4,12,High-Value
13578,1,147.66,408,1,1,1,3,At-Risk
13579,5,1374.34,14,4,3,3,10,High-Value
13580,1,107.75,405,1,1,1,3,At-Risk
13581,2,280.53000000000003,308,2,2,1,5,Other
13582,2,241.68,389,1,2,1,4,At-Risk
13583,2,1445.031,155,2,2,3,7,Other
13584,3,385.7,306,2,2,2,6,Other
13585,3,684.54,530,1,2,2,5,At-Risk
13586,1,127.28,540,1,1,1,3,At-Risk
13587,4,1673.5,63,3,3,3,9,High-Value
13588,9,2478.95,15,4,4,4,12,High-Value
13589,6,1120.74,14,4,3,3,10,High-Value
13590,18,6336.04,10,4,4,4,12,High-Value
13591,7,2093.94,64,3,3,3,9,High-Value
13592,4,247.95999999999998,35,3,3,1,7,Loyal
13593,14,5493.29,107,2,4,4,10,High-Value
13594,2,533.32,52,3,2,2,7,Other
13595,3,784.48,516,1,2,2,5,At-Risk
13596,2,664.11,5,4,2,2,8,Other
13597,2,396.71000000000004,399,1,2,2,5,At-Risk
13598,5,761.96,46,3,3,2,8,Loyal
13599,33,9811.04,0,4,4,4,12,High-Value
13600,2,518.42,311,2,2,2,6,Other
13601,4,1159.99,44,3,3,3,9,High-Value
13602,4,1025.17,64,3,3,3,9,High-Value
13603,1,164.34,25,3,1,1,5,One-Time
13604,1,717.62,658,1,1,2,4,At-Risk
13605,2,522.67,386,1,2,2,5,At-Risk
13606,3,276.75,28,3,2,1,6,Other
13607,2,1075.81,39,3,2,3,8,Other
13608,1,232.05,540,1,1,1,3,At-Risk
13609,1,167.35,592,1,1,1,3,At-Risk
13610,14,2102.46,11,4,4,3,11,High-Value
13611,10,3297.9300000000003,88,3,4,4,11,High-Value
13612,1,818.29,632,1,1,2,4,At-Risk
13613,5,1039.8500000000001,452,1,3,3,7,At-Risk
13614,6,2332.74,23,4,3,4,11,High-Value
13615,8,6272.53,318,2,4,4,10,High-Value
13616,2,283.85,567,1,2,1,4,At-Risk
13617,8,1278.75,39,3,4,3,10,High-Value
13618,1,177.34,173,2,1,1,4,One-Time
13619,2,223.44,544,1,2,1,4,At-Risk
13620,1,112.34,527,1,1,1,3,At-Risk
13621,1,213.85,116,2,1,1,4,One-Time
13622,1,658.95,695,1,1,2,4,At-Risk
13623,10,2533.06,30,3,4,4,11,High-Value
13624,1,462.08,387,1,1,2,4,At-Risk
13625,1,301.26,596,1,1,1,3,At-Risk
13626,2,707.04,252,2,2,2,6,Other
13627,7,2245.9,58,3,3,4,10,High-Value
13628,1,310.14,675,1,1,1,3,At-Risk
13629,19,13370.86,22,4,4,4,12,High-Value
13630,7,2031.78,4,4,3,3,10,High-Value
13631,11,3070.42,99,2,4,4,10,High-Value
13632,8,3645.81,24,4,4,4,12,High-Value
13634,15,4988.08,32,3,4,4,11,High-Value
13635,4,2999.16,67,3,3,4,10,High-Value
13636,5,949.12,36,3,3,3,9,High-Value
13637,3,803.05,51,3,2,2,7,Other
13638,1,122.64,15,4,1,1,6,One-Time
13639,2,1346.27,73,3,2,3,8,Other
13640,1,405.0,610,1,1,2,4,At-Risk
13641,4,942.37,640,1,3,3,7,At-Risk
13642,4,472.2,215,2,3,2,7,Other
13643,10,2156.77,30,3,4,3,10,High-Value
13644,4,2624.26,15,4,3,4,11,High-Value
13645,1,252.1,119,2,1,1,4,One-Time
13646,2,326.25,399,1,2,1,4,At-Risk
13647,8,3041.68,9,4,4,4,12,High-Value
13648,8,1759.0700000000002,399,1,4,3,8,At-Risk
13649,6,1453.68,256,2,3,3,8,Other
13650,10,3288.0,16,4,4,4,12,High-Value
13651,2,211.85,39,3,2,1,6,Other
13652,5,2262.05,45,3,3,4,10,High-Value
13653,1,152.20000000000002,487,1,1,1,3,At-Risk
13654,11,6308.0,42,3,4,4,11,High-Value
13655,6,2280.51,113,2,3,4,9,High-Value
13656,4,1078.85,164,2,3,3,8,Other
13657,2,382.14,10,4,2,2,8,Other
13658,9,6025.5,9,4,4,4,12,High-Value
13659,12,4884.68,205,2,4,4,10,High-Value
13660,1,306.64,399,1,1,1,3,At-Risk
13661,1,325.24,602,1,1,1,3,At-Risk
13662,11,2233.61,85,3,4,3,10,High-Value
13663,5,2047.51,178,2,3,3,8,Other
13665,3,1711.66,385,1,2,3,6,At-Risk
13666,5,127.05,59,3,3,1,7,Loyal
13667,1,299.05,148,2,1,1,4,One-Time
13668,35,12948.48,2,4,4,4,12,High-Value
13669,3,413.55,50,3,2,2,7,Other
13670,1,349.7,74,3,1,2,6,Other
13671,1,172.6,394,1,1,1,3,At-Risk
13672,3,419.92,300,2,2,2,6,Other
13673,2,387.44,18,4,2,2,8,Other
13674,1,240.68,432,1,1,1,3,At-Risk
13675,2,486.82000000000005,150,2,2,2,6,Other
13676,2,243.9,538,1,2,1,4,At-Risk
13677,2,551.24,404,1,2,2,5,At-Risk
13678,1,232.6,151,2,1,1,4,One-Time
13679,3,281.26,493,1,2,1,4,At-Risk
13680,12,11419.67,0,4,4,4,12,High-Value
13681,4,827.83,17,4,3,2,9,High-Value
13682,1,59.5,186,2,1,1,4,One-Time
13683,1,258.6,457,1,1,1,3,At-Risk
13684,4,594.88,285,2,3,2,7,Other
13685,7,3119.44,2,4,3,4,11,High-Value
13686,3,409.04,182,2,2,2,6,Other
13687,1,11880.84,437,1,1,4,6,At-Risk
13688,1,375.5,634,1,1,2,4,At-Risk
13689,2,1259.5,62,3,2,3,8,Other
13690,1,172.25,58,3,1,1,5,One-Time
13691,1,210.78,395,1,1,1,3,At-Risk
13692,5,3114.4,24,4,3,4,11,High-Value
13693,9,2011.82,373,2,4,3,9,High-Value
13694,143,195640.69,3,4,4,4,12,High-Value
13695,16,2770.73,30,3,4,4,11,High-Value
13696,3,2020.4,421,1,2,3,6,At-Risk
13697,1,151.3,38,3,1,1,5,One-Time
13698,2,451.73,596,1,2,2,5,At-Risk
13699,2,764.1500000000001,154,2,2,2,6,Other
13700,13,2596.9700000000003,25,3,4,4,11,High-Value
13701,1,161.0,446,1,1,1,3,At-Risk
13702,1,135.18,445,1,1,1,3,At-Risk
13703,2,425.56,317,2,2,2,6,Other
13704,9,2308.06,4,4,4,4,12,High-Value
13705,7,1717.19,7,4,3,3,10,High-Value
13706,2,631.17,302,2,2,2,6,Other
13707,5,3365.86,266,2,3,4,9,High-Value
13708,1,283.33,270,2,1,1,4,One-Time
13709,18,7571.35,3,4,4,4,12,High-Value
13710,3,509.52,31,3,2,2,7,Other
13711,9,1792.26,218,2,4,3,9,High-Value
13712,2,766.42,246,2,2,2,6,Other
13713,3,740.76,407,1,2,2,5,At-Risk
13714,1,161.35,464,1,1,1,3,At-Risk
13715,17,8153.04,280,2,4,4,10,High-Value
13716,1,138.28,268,2,1,1,4,One-Time
13717,8,1763.3,31,3,4,3,10,High-Value
13718,2,306.55,245,2,2,1,5,Other
13719,11,2782.1,14,4,4,4,12,High-Value
13720,4,799.9,116,2,3,2,7,Other
13721,2,741.54,35,3,2,2,7,Other
13722,10,5635.41,131,2,4,4,10,High-Value
13723,6,1194.08,216,2,3,3,8,Other
13724,1,213.01,636,1,1,1,3,At-Risk
13725,8,1980.56,49,3,4,3,10,High-Value
13726,2,1079.66,38,3,2,3,8,Other
13727,8,1074.15,28,3,4,3,10,High-Value
13728,16,2855.17,36,3,4,4,11,High-Value
13729,3,724.73,435,1,2,2,5,At-Risk
13730,2,752.6,135,2,2,2,6,Other
13731,2,610.59,218,2,2,2,6,Other
13732,1,491.86,27,3,1,2,6,Other
13733,2,487.03000000000003,410,1,2,2,5,At-Risk
13734,4,6695.690000000001,508,1,3,4,8,At-Risk
13735,13,9762.77,24,4,4,4,12,High-Value
13736,7,2752.47,4,4,3,4,11,High-Value
13737,1,339.6,199,2,1,2,5,Other
13738,1,434.78000000000003,395,1,1,2,4,At-Risk
13739,2,292.2,17,4,2,1,7,Other
13740,5,1582.77,240,2,3,3,8,Other
13741,3,668.4300000000001,71,3,2,2,7,Other
13742,12,3107.87,16,4,4,4,12,High-Value
13743,7,1341.6,2,4,3,3,10,High-Value
13744,2,1080.52,94,3,2,3,8,Other
13745,2,777.36,161,2,2,2,6,Other
13746,1,176.69,413,1,1,1,3,At-Risk
13747,2,169.79999999999998,373,2,2,1,5,Other
13748,9,2064.35,95,2,4,3,9,High-Value
13750,11,3602.18,53,3,4,4,11,High-Value
13751,1,296.25,287,2,1,1,4,One-Time
13752,7,1579.8300000000002,123,2,4,3,9,High-Value
13753,4,2094.57,287,2,3,3,8,Other
13754,3,447.05,151,2,2,2,6,Other
13755,9,2108.06,3,4,4,3,11,High-Value
13756,23,8655.95,1,4,4,4,12,High-Value
13757,1,195.54999999999998,674,1,1,1,3,At-Risk
13758,14,8595.29,11,4,4,4,12,High-Value
13759,2,659.4100000000001,32,3,2,2,7,Other
13760,5,1363.64,53,3,3,3,9,High-Value
13761,6,1952.17,49,3,3,3,9,High-Value
13762,5,2472.48,218,2,3,4,9,High-Value
13763,3,5217.44,62,3,2,4,9,High-Value
13764,6,2908.67,70,3,3,4,10,High-Value
13765,1,352.821,652,1,1,2,4,At-Risk
13766,1,190.35,494,1,1,1,3,At-Risk
13767,73,33903.57,1,4,4,4,12,High-Value
13768,2,875.97,726,1,2,3,6,At-Risk
13769,20,5478.12,1,4,4,4,12,High-Value
13770,4,785.37,421,1,3,2,6,At-Risk
13771,9,5728.82,63,3,4,4,11,High-Value
13772,8,3100.02,33,3,4,4,11,High-Value
13773,2,301.54,396,1,2,1,4,At-Risk
13774,1,345.0,81,3,1,2,6,Other
13775,1,1049.66,590,1,1,3,5,At-Risk
13777,61,49638.26,0,4,4,4,12,High-Value
13778,4,1124.49,102,2,3,3,8,Other
13779,1,161.13,515,1,1,1,3,At-Risk
13780,3,732.07,6,4,2,2,8,Other
13781,3,778.83,250,2,2,2,6,Other
13782,13,1786.08,12,4,4,3,11,High-Value
13783,4,1542.09,487,1,3,3,7,At-Risk
13784,14,2910.23,9,4,4,4,12,High-Value
13785,4,542.49,428,1,3,2,6,At-Risk
13786,6,3127.99,366,2,3,4,9,High-Value
13787,6,1222.5,75,3,3,3,9,High-Value
13788,1,3.75,504,1,1,1,3,At-Risk
13789,1,239.46,387,1,1,1,3,At-Risk
13790,1,348.8,3,4,1,2,7,Other
13791,2,1516.0,127,2,2,3,7,Other
13792,3,383.95,65,3,2,2,7,Other
13793,1,96.0,646,1,1,1,3,At-Risk
13794,1,126.03,546,1,1,1,3,At-Risk
13795,4,836.3,387,1,3,2,6,At-Risk
13796,1,289.7,498,1,1,1,3,At-Risk
13797,3,1179.45,436,1,2,3,6,At-Risk
13798,110,75428.87,0,4,4,4,12,High-Value
13799,9,2803.57,116,2,4,4,10,High-Value
13800,3,1679.56,309,2,2,3,7,Other
13801,1,324.8,66,3,1,1,5,One-Time
13802,19,26259.11,138,2,4,4,10,High-Value
13803,3,1338.91,254,2,2,3,7,Other
13804,9,3161.12,30,3,4,4,11,High-Value
13805,2,924.6,51,3,2,3,8,Other
13806,1,256.38,63,3,1,1,5,One-Time
13807,3,422.2,366,2,2,2,6,Other
13808,5,1747.66,5,4,3,3,10,High-Value
13809,3,679.7,304,2,2,2,6,Other
13810,2,827.51,28,3,2,2,7,Other
13811,2,519.75,183,2,2,2,6,Other
13812,3,485.0,41,3,2,2,7,Other
13813,8,2387.4700000000003,39,3,4,4,11,High-Value
13814,3,2257.32,91,3,2,4,9,High-Value
13815,8,6737.74,21,4,4,4,12,High-Value
13816,2,499.67,23,4,2,2,8,Other
13817,2,328.98,28,3,2,1,6,Other
13818,1,61.28,429,1,1,1,3,At-Risk
13819,6,2642.35,301,2,3,4,9,High-Value
13820,3,652.75,417,1,2,2,5,At-Risk
13821,6,1379.08,144,2,3,3,8,Other
13822,2,632.0,5,4,2,2,8,Other
13823,7,3403.4500000000003,18,4,4,4,12,High-Value
13824,12,3314.76,32,3,4,4,11,High-Value
13825,2,255.59,621,1,2,1,4,At-Risk
13826,1,189.5,175,2,1,1,4,One-Time
13827,3,409.8,57,3,2,2,7,Other
13828,1,209.49,21,4,1,1,6,One-Time
13829,1,102.0,420,1,1,1,3,At-Risk
13830,1,156.85,581,1,1,1,3,At-Risk
13831,18,6585.54,15,4,4,4,12,High-Value
13832,2,609.89,18,4,2,2,8,Other
13833,2,700.41,158,2,2,2,6,Other
13834,2,324.19,576,1,2,1,4,At-Risk
13835,7,1095.27,24,4,4,3,11,High-Value
13836,2,620.37,398,1,2,2,5,At-Risk
13837,2,266.59000000000003,211,2,2,1,5,Other
13838,10,1690.07,5,4,4,3,11,High-Value
13839,1,139.95000000000002,485,1,1,1,3,At-Risk
13840,1,651.4,415,1,1,2,4,At-Risk
13841,1,85.0,252,2,1,1,4,One-Time
13842,18,5319.34,58,3,4,4,11,High-Value
13843,1,319.75,380,1,1,1,3,At-Risk
13844,1,361.62,10,4,1,2,7,Other
13845,1,312.98,64,3,1,1,5,One-Time
13846,4,1307.79,24,4,3,3,10,High-Value
13847,1,310.72,719,1,1,1,3,At-Risk
13848,8,3015.0,91,3,4,4,11,High-Value
13849,5,3469.3,51,3,3,4,10,High-Value
13850,1,1595.48,128,2,1,3,6,Other
13851,8,4606.46,95,2,4,4,10,High-Value
13852,1,187.35000000000002,610,1,1,1,3,At-Risk
13853,1,1090.1399999999999,56,3,1,3,7,Other
13854,39,11944.56,8,4,4,4,12,High-Value
13855,4,1310.3400000000001,500,1,3,3,7,At-Risk
13856,11,1142.03,168,2,4,3,9,High-Value
13857,6,1000.91,392,1,3,3,7,At-Risk
13858,1,216.17000000000002,56,3,1,1,5,One-Time
13859,2,515.86,325,2,2,2,6,Other
13860,5,1245.9,0,4,3,3,10,High-Value
13861,2,273.26,428,1,2,1,4,At-Risk
13862,9,2556.09,17,4,4,4,12,High-Value
13863,4,1239.55,247,2,3,3,8,Other
13864,1,662.4000000000001,386,1,1,2,4,At-Risk
13865,4,501.56,57,3,3,2,8,Loyal
13866,1,145.67000000000002,73,3,1,1,5,One-Time
13867,3,1005.09,30,3,2,3,8,Other
13868,2,3192.54,6,4,2,4,10,High-Value
13869,10,7996.87,122,2,4,4,10,High-Value
13870,15,5712.08,1,4,4,4,12,High-Value
13871,17,7885.85,22,4,4,4,12,High-Value
13872,3,919.57,526,1,2,3,6,At-Risk
13873,8,1038.92,119,2,4,3,9,High-Value
13874,7,2049.15,357,2,4,3,9,High-Value
13875,14,4814.37,53,3,4,4,11,High-Value
13876,1,122.7,63,3,1,1,5,One-Time
13877,3,449.68,85,3,2,2,7,Other
13878,4,2416.9,54,3,3,4,10,High-Value
13879,1,395.5,645,1,1,2,4,At-Risk
13880,17,4293.86,20,4,4,4,12,High-Value
13881,43,45179.1,3,4,4,4,12,High-Value
13882,5,1191.13,2,4,3,3,10,High-Value
13883,14,6535.37,10,4,4,4,12,High-Value
13884,10,1825.03,6,4,4,3,11,High-Value
13885,2,506.8,188,2,2,2,6,Other
13886,1,243.56,70,3,1,1,5,One-Time
13887,1,349.55,203,2,1,2,5,Other
13888,7,2001.5900000000001,119,2,4,3,9,High-Value
13889,6,1991.23,92,3,3,3,9,High-Value
13890,14,2927.38,0,4,4,4,12,High-Value
13891,3,859.21,377,2,2,3,7,Other
13892,6,1267.65,26,3,3,3,9,High-Value
13893,1,821.1,297,2,1,2,5,Other
13894,3,564.62,23,4,2,2,8,Other
13895,6,4008.52,27,3,3,4,10,High-Value
13896,1,388.55,625,1,1,2,4,At-Risk
13897,3,1160.72,49,3,2,3,8,Other
13898,2,686.4,325,2,2,2,6,Other
13899,2,388.52,15,4,2,2,8,Other
13900,6,1610.5900000000001,182,2,3,3,8,Other
13901,15,5676.34,71,3,4,4,11,High-Value
13902,5,34023.26,631,1,3,4,8,At-Risk
13903,1,165.45000000000002,399,1,1,1,3,At-Risk
13904,2,332.64,36,3,2,1,6,Other
13905,1,312.65,732,1,1,1,3,At-Risk
13906,1,42.0,408,1,1,1,3,At-Risk
13907,1,136.8,691,1,1,1,3,At-Risk
13908,4,2319.55,79,3,3,4,10,High-Value
13909,2,282.85,422,1,2,1,4,At-Risk
13911,20,4234.99,56,3,4,4,11,High-Value
13912,1,124.95,423,1,1,1,3,At-Risk
13913,1,42.22,506,1,1,1,3,At-Risk
13914,2,626.45,11,4,2,2,8,Other
13915,1,70.80000000000001,393,1,1,1,3,At-Risk
13916,4,1275.81,463,1,3,3,7,At-Risk
13917,2,272.04,49,3,2,1,6,Other
13918,2,1212.8400000000001,49,3,2,3,8,Other
13919,4,1252.68,58,3,3,3,9,High-Value
13920,4,1774.68,431,1,3,3,7,At-Risk
13921,4,730.7,401,1,3,2,6,At-Risk
13922,3,865.2,351,2,2,3,7,Other
13923,1,351.13,53,3,1,2,6,Other
13924,6,1838.8500000000001,1,4,3,3,10,High-Value
13925,4,678.25,92,3,3,2,8,Loyal
13926,1,223.85000000000002,22,4,1,1,6,One-Time
13927,2,708.26,74,3,2,2,7,Other
13928,4,464.57,10,4,3,2,9,High-Value
13929,11,3494.1,168,2,4,4,10,High-Value
13930,2,337.34,57,3,2,1,6,Other
13931,11,5257.38,95,2,4,4,10,High-Value
13932,1,307.40000000000003,294,2,1,1,4,One-Time
13933,2,608.79,108,2,2,2,6,Other
13934,1,922.1,263,2,1,3,6,Other
13935,3,6116.92,596,1,2,4,7,At-Risk
13936,3,939.6600000000001,179,2,2,3,7,Other
13937,2,880.13,168,2,2,3,7,Other
13938,1,71.66,34,3,1,1,5,One-Time
13939,7,1560.96,22,4,4,3,11,High-Value
13940,4,839.14,16,4,3,2,9,High-Value
13941,15,10027.18,21,4,4,4,12,High-Value
13942,1,320.0,534,1,1,1,3,At-Risk
13943,1,246.54000000000002,577,1,1,1,3,At-Risk
13944,1,200.43,652,1,1,1,3,At-Risk
13945,2,854.1500000000001,394,1,2,2,5,At-Risk
13946,6,1876.23,78,3,3,3,9,High-Value
13947,1,90.60000000000001,64,3,1,1,5,One-Time
13948,4,548.76,360,2,3,2,7,Other
13949,6,2427.32,2,4,3,4,11,High-Value
13950,4,745.0600000000001,10,4,3,2,9,High-Value
13951,3,674.45,175,2,2,2,6,Other
13952,14,12823.521,217,2,4,4,10,High-Value
13953,12,6640.68,6,4,4,4,12,High-Value
13954,2,439.92,1,4,2,2,8,Other
13955,3,544.07,153,2,2,2,6,Other
13956,5,1019.27,4,4,3,3,10,High-Value
13957,3,458.25,417,1,2,2,5,At-Risk
13958,8,4709.2300000000005,379,1,4,4,9,High-Value
13959,6,1064.77,78,3,3,3,9,High-Value
13960,2,230.22000000000003,20,4,2,1,7,Other
13961,1,538.4,391,1,1,2,4,At-Risk
13962,3,362.8,21,4,2,2,8,Other
13963,17,2860.57,307,2,4,4,10,High-Value
13964,2,438.9,386,1,2,2,5,At-Risk
13965,3,996.61,476,1,2,3,6,At-Risk
13966,1,384.26,434,1,1,2,4,At-Risk
13967,2,166.3,145,2,2,1,5,Other
13968,1,123.66,422,1,1,1,3,At-Risk
13969,35,12973.460000000001,6,4,4,4,12,High-Value
13970,2,846.55,385,1,2,2,5,At-Risk
13971,14,4667.57,18,4,4,4,12,High-Value
13972,2,190.25,70,3,2,1,6,Other
13973,1,264.7,286,2,1,1,4,One-Time
13974,2,677.72,48,3,2,2,7,Other
13975,12,5256.4,30,3,4,4,11,High-Value
13976,4,1192.3600000000001,206,2,3,3,8,Other
13977,1,519.8100000000001,410,1,1,2,4,At-Risk
13978,2,196.79,14,4,2,1,7,Other
13979,7,3373.63,72,3,4,4,11,High-Value
13980,5,768.82,59,3,3,2,8,Loyal
13981,1,331.14,415,1,1,1,3,At-Risk
13982,9,3954.29,38,3,4,4,11,High-Value
13983,21,6753.89,29,3,4,4,11,High-Value
13984,12,1893.8,26,3,4,3,10,High-Value
13985,22,10020.86,3,4,4,4,12,High-Value
13986,1,320.46,16,4,1,1,6,One-Time
13987,2,682.54,379,1,2,2,5,At-Risk
13988,8,4757.8,19,4,4,4,12,High-Value
13989,5,2026.06,65,3,3,3,9,High-Value
13990,1,311.3,212,2,1,1,4,One-Time
13991,6,851.88,11,4,3,2,9,High-Value
13992,3,219.5,29,3,2,1,6,Other
13993,19,6775.71,42,3,4,4,11,High-Value
13994,6,2274.14,3,4,3,4,11,High-Value
13995,14,3902.01,14,4,4,4,12,High-Value
13996,2,845.76,385,1,2,2,5,At-Risk
13997,3,376.46,518,1,2,2,5,At-Risk
13998,3,566.7,446,1,2,2,5,At-Risk
13999,29,9502.26,9,4,4,4,12,High-Value
14000,5,2046.3400000000001,210,2,3,3,8,Other
14001,9,4228.85,45,3,4,4,11,High-Value
14002,2,529.73,133,2,2,2,6,Other
14003,1,209.41,732,1,1,1,3,At-Risk
14004,11,6258.45,42,3,4,4,11,High-Value
14005,5,2874.72,9,4,3,4,11,High-Value
14006,7,2196.67,115,2,4,3,9,High-Value
14007,1,79.48,512,1,1,1,3,At-Risk
14008,1,509.04,431,1,1,2,4,At-Risk
14009,3,1099.91,197,2,2,3,7,Other
14010,2,445.15,564,1,2,2,5,At-Risk
14011,2,457.82,479,1,2,2,5,At-Risk
14012,1,328.8,277,2,1,1,4,One-Time
14013,5,1084.57,109,2,3,3,8,Other
14014,3,1948.21,76,3,2,3,8,Other
14015,1,917.34,52,3,1,3,7,Other
14016,11,11303.41,161,2,4,4,10,High-Value
14017,1,229.75,570,1,1,1,3,At-Risk
14018,1,367.15000000000003,644,1,1,2,4,At-Risk
14019,3,1421.61,46,3,2,3,8,Other
14020,4,1249.01,16,4,3,3,10,High-Value
14021,7,1716.58,154,2,4,3,9,High-Value
14022,2,792.15,224,2,2,2,6,Other
14023,2,584.07,6,4,2,2,8,Other
14024,3,645.74,121,2,2,2,6,Other
14025,8,4057.9,464,1,4,4,9,High-Value
14026,2,713.11,470,1,2,2,5,At-Risk
14027,1,104.82,60,3,1,1,5,One-Time
14028,3,10396.5,549,1,2,4,7,At-Risk
14029,2,467.66,62,3,2,2,7,Other
14030,20,7521.8,17,4,4,4,12,High-Value
14031,44,39019.51,6,4,4,4,12,High-Value
14032,16,4546.41,1,4,4,4,12,High-Value
14033,1,109.44,554,1,1,1,3,At-Risk
14034,3,648.89,21,4,2,2,8,Other
14035,9,2794.75,28,3,4,4,11,High-Value
14036,1,626.65,284,2,1,2,5,Other
14037,6,836.95,175,2,3,2,7,Other
14038,5,3069.88,77,3,3,4,10,High-Value
14039,2,267.28000000000003,32,3,2,1,6,Other
14040,35,12523.81,40,3,4,4,11,High-Value
14041,1,141.41,265,2,1,1,4,One-Time
14042,1,431.98,724,1,1,2,4,At-Risk
14043,2,302.6,490,1,2,1,4,At-Risk
14044,10,3073.95,26,3,4,4,11,High-Value
14045,16,10986.63,108,2,4,4,10,High-Value
14046,1,151.59,283,2,1,1,4,One-Time
14047,14,3968.11,8,4,4,4,12,High-Value
14048,3,748.69,304,2,2,2,6,Other
14049,13,13023.4,16,4,4,4,12,High-Value
14050,2,746.36,31,3,2,2,7,Other
14051,37,21770.98,0,4,4,4,12,High-Value
14052,2,466.66,19,4,2,2,8,Other
14053,4,572.3,123,2,3,2,7,Other
14054,1,92.46000000000001,64,3,1,1,5,One-Time
14055,3,1520.96,105,2,2,3,7,Other
14056,23,8152.71,0,4,4,4,12,High-Value
14057,22,8346.66,23,4,4,4,12,High-Value
14058,2,469.19,462,1,2,2,5,At-Risk
14059,1,183.6,266,2,1,1,4,One-Time
14060,30,8898.24,4,4,4,4,12,High-Value
14061,3,917.4300000000001,506,1,2,3,6,At-Risk
14062,24,25585.65,9,4,4,4,12,High-Value
14063,7,9471.5,686,1,4,4,9,High-Value
14064,15,3260.2400000000002,28,3,4,4,11,High-Value
14065,3,891.02,388,1,2,3,6,At-Risk
14066,1,152.55,266,2,1,1,4,One-Time
14067,2,374.7,63,3,2,2,7,Other
14068,4,1516.72,319,2,3,3,8,Other
14069,2,225.81,514,1,2,1,4,At-Risk
14070,1,321.6,684,1,1,1,3,At-Risk
14071,8,1422.75,3,4,4,3,11,High-Value
14072,1,390.85,666,1,1,2,4,At-Risk
14073,1,151.04,31,3,1,1,5,One-Time
14074,1,219.4,622,1,1,1,3,At-Risk
14075,5,1724.87,4,4,3,3,10,High-Value
14076,1,118.67,128,2,1,1,4,One-Time
14077,6,615.08,40,3,3,2,8,Loyal
14078,9,1551.82,101,2,4,3,9,High-Value
14079,1,375.1,124,2,1,2,5,Other
14080,5,1115.68,32,3,3,3,9,High-Value
14081,10,4867.57,301,2,4,4,10,High-Value
14082,2,413.36,364,2,2,2,6,Other
14083,11,1082.19,3,4,4,3,11,High-Value
14084,1,150.5,511,1,1,1,3,At-Risk
14085,32,9705.67,1,4,4,4,12,High-Value
14086,1,39.95,462,1,1,1,3,At-Risk
14087,3,829.47,2,4,2,2,8,Other
14088,16,64036.8,9,4,4,4,12,High-Value
14089,1,158.75,56,3,1,1,5,One-Time
14090,1,76.32000000000001,324,2,1,1,4,One-Time
14091,2,9530.08,653,1,2,4,7,At-Risk
14092,24,7229.45,7,4,4,4,12,High-Value
14093,1,433.86,11,4,1,2,7,Other
14094,1,311.77,439,1,1,1,3,At-Risk
14095,1,2.95,722,1,1,1,3,At-Risk
14096,17,53258.43,3,4,4,4,12,High-Value
14097,2,422.86,480,1,2,2,5,At-Risk
14098,1,147.35,36,3,1,1,5,One-Time
14099,20,5750.91,15,4,4,4,12,High-Value
14100,1,191.95,137,2,1,1,4,One-Time
14101,13,9961.93,73,3,4,4,11,High-Value
14102,5,1105.88,4,4,3,3,10,High-Value
14104,5,740.53,154,2,3,2,7,Other
14105,5,5988.83,238,2,3,4,9,High-Value
14106,1,214.8,736,1,1,1,3,At-Risk
14107,11,4877.3,51,3,4,4,11,High-Value
14108,4,1044.96,30,3,3,3,9,High-Value
14109,1,144.2,72,3,1,1,5,One-Time
14110,33,12987.95,3,4,4,4,12,High-Value
14111,4,692.85,13,4,3,2,9,High-Value
14112,13,5834.59,22,4,4,4,12,High-Value
14113,16,7092.610000000001,3,4,4,4,12,High-Value
14114,7,1364.09,273,2,4,3,9,High-Value
14115,2,622.67,501,1,2,2,5,At-Risk
14116,5,1382.74,19,4,3,3,10,High-Value
14117,1,90.0,143,2,1,1,4,One-Time
14118,1,458.45,428,1,1,2,4,At-Risk
14119,2,183.37,375,2,2,1,5,Other
14121,4,2780.15,3,4,3,4,11,High-Value
14122,3,362.42,405,1,2,2,5,At-Risk
14123,1,436.18,732,1,1,2,4,At-Risk
14124,1,419.58,83,3,1,2,6,Other
14125,3,2720.63,10,4,2,4,10,High-Value
14126,4,1172.46,7,4,3,3,10,High-Value
14127,6,1900.0800000000002,122,2,3,3,8,Other
14128,3,924.21,60,3,2,3,8,Other
14129,9,2591.34,1,4,4,4,12,High-Value
14130,4,1858.77,318,2,3,3,8,Other
14131,1,168.22,648,1,1,1,3,At-Risk
14132,11,3586.03,1,4,4,4,12,High-Value
14133,4,911.14,129,2,3,3,8,Other
14134,15,11123.35,382,1,4,4,9,High-Value
14135,24,8839.67,1,4,4,4,12,High-Value
14136,5,1570.81,400,1,3,3,7,At-Risk
14137,1,332.7,695,1,1,1,3,At-Risk
14138,2,965.88,1,4,2,3,9,High-Value
14139,4,1086.8,45,3,3,3,9,High-Value
14140,2,935.05,3,4,2,3,9,High-Value
14141,4,915.13,2,4,3,3,10,High-Value
14142,2,671.34,372,2,2,2,6,Other
14143,1,115.8,133,2,1,1,4,One-Time
14144,1,30.6,485,1,1,1,3,At-Risk
14145,7,7600.05,46,3,4,4,11,High-Value
14146,12,9450.3,8,4,4,4,12,High-Value
14147,9,2590.2,77,3,4,4,11,High-Value
14148,2,466.29,233,2,2,2,6,Other
14149,1,446.62,220,2,1,2,5,Other
14150,2,658.64,35,3,2,2,7,Other
14151,2,679.45,672,1,2,2,5,At-Risk
14152,7,1997.3400000000001,74,3,4,3,10,High-Value
14153,1,233.39999999999998,482,1,1,1,3,At-Risk
14154,8,6460.7,238,2,4,4,10,High-Value
14155,1,118.75,265,2,1,1,4,One-Time
14156,144,303069.88,9,4,4,4,12,High-Value
14157,5,978.69,19,4,3,3,10,High-Value
14158,1,507.65999999999997,39,3,1,2,6,Other
14159,20,7849.58,19,4,4,4,12,High-Value
14160,7,8421.47,609,1,4,4,9,High-Value
14161,7,2996.93,215,2,4,4,10,High-Value
14162,2,289.36,173,2,2,1,5,Other
14163,5,2594.62,86,3,3,4,10,High-Value
14164,2,1631.77,70,3,2,3,8,Other
14165,1,120.44,275,2,1,1,4,One-Time
14166,2,251.15,504,1,2,1,4,At-Risk
14167,8,1274.29,38,3,4,3,10,High-Value
14168,2,370.45,420,1,2,2,5,At-Risk
14169,2,613.11,430,1,2,2,5,At-Risk
14170,3,570.1800000000001,374,2,2,2,6,Other
14171,2,498.79,97,2,2,2,6,Other
14172,3,369.02,604,1,2,2,5,At-Risk
14173,6,586.0,10,4,3,2,9,High-Value
14174,1,134.46,32,3,1,1,5,One-Time
14175,8,7678.88,59,3,4,4,11,High-Value
14176,5,756.46,296,2,3,2,7,Other
14177,13,2209.69,85,3,4,3,10,High-Value
14178,7,1580.26,8,4,4,3,11,High-Value
14179,2,701.57,40,3,2,2,7,Other
14180,33,6117.5,10,4,4,4,12,High-Value
14181,2,308.35,410,1,2,1,4,At-Risk
14182,4,678.77,443,1,3,2,6,At-Risk
14183,2,278.34,410,1,2,1,4,At-Risk
14184,1,452.89,66,3,1,2,6,Other
14185,1,197.65,330,2,1,1,4,One-Time
14186,5,1550.63,426,1,3,3,7,At-Risk
14187,1,123.5,473,1,1,1,3,At-Risk
14188,6,2054.36,30,3,3,3,9,High-Value
14189,16,5503.15,1,4,4,4,12,High-Value
14190,1,79.9,665,1,1,1,3,At-Risk
14191,15,4817.66,1,4,4,4,12,High-Value
14192,1,293.74,387,1,1,1,3,At-Risk
14193,3,1210.19,67,3,2,3,8,Other
14194,36,18670.59,4,4,4,4,12,High-Value
14195,6,2615.6,201,2,3,4,9,High-Value
14196,1,335.52,106,2,1,1,4,One-Time
14197,1,390.05,410,1,1,2,4,At-Risk
14198,9,1569.73,17,4,4,3,11,High-Value
14199,4,1091.7,217,2,3,3,8,Other
14200,1,379.2,616,1,1,2,4,At-Risk
14201,10,1193.54,59,3,4,3,10,High-Value
14202,3,847.76,380,1,2,2,5,At-Risk
14203,1,339.34,396,1,1,1,3,At-Risk
14204,4,1024.83,1,4,3,3,10,High-Value
14205,9,2414.2,16,4,4,4,12,High-Value
14206,3,1185.01,238,2,2,3,7,Other
14207,1,157.8,687,1,1,1,3,At-Risk
14208,2,567.05,94,3,2,2,7,Other
14209,15,4993.27,10,4,4,4,12,High-Value
14210,16,5556.570000000001,105,2,4,4,10,High-Value
14211,18,4402.29,52,3,4,4,11,High-Value
14212,2,2190.14,89,3,2,3,8,Other
14213,1,1192.2,404,1,1,3,5,At-Risk
14214,5,1004.38,30,3,3,3,9,High-Value
14215,9,3250.33,11,4,4,4,12,High-Value
14216,5,2150.04,2,4,3,3,10,High-Value
14217,23,3298.59,1,4,4,4,12,High-Value
14218,1,169.48000000000002,42,3,1,1,5,One-Time
14219,3,633.83,3,4,2,2,8,Other
14220,4,1515.0,246,2,3,3,8,Other
14221,17,6517.49,41,3,4,4,11,High-Value
14222,1,683.17,176,2,1,2,5,Other
14223,3,991.13,91,3,2,3,8,Other
14224,9,1841.71,109,2,4,3,9,High-Value
14225,4,2031.07,434,1,3,3,7,At-Risk
14226,6,2985.13,28,3,3,4,10,High-Value
14227,15,6366.16,25,3,4,4,11,High-Value
14228,3,745.5,437,1,2,2,5,At-Risk
14229,7,2594.04,51,3,4,4,11,High-Value
14230,3,979.8000000000001,435,1,2,3,6,At-Risk
14231,4,1235.6200000000001,183,2,3,3,8,Other
14232,5,2048.07,42,3,3,3,9,High-Value
14233,7,2904.27,48,3,4,4,11,High-Value
14234,4,754.12,21,4,3,2,9,High-Value
14235,9,4717.99,74,3,4,4,11,High-Value
14236,5,1555.34,80,3,3,3,9,High-Value
14237,2,471.14,372,2,2,2,6,Other
14238,3,434.23,325,2,2,2,6,Other
14239,21,4263.17,42,3,4,4,11,High-Value
14240,3,1247.49,29,3,2,3,8,Other
14241,2,333.70000000000005,183,2,2,1,5,Other
14242,2,280.55,234,2,2,1,5,Other
14243,17,7217.75,8,4,4,4,12,High-Value
14244,1,366.42,660,1,1,2,4,At-Risk
14245,2,1693.45,219,2,2,3,7,Other
14246,3,1474.06,110,2,2,3,7,Other
14247,5,753.56,277,2,3,2,7,Other
14248,3,1032.95,317,2,2,3,7,Other
14249,12,5400.461,410,1,4,4,9,High-Value
14250,3,1904.05,6,4,2,3,9,High-Value
14251,5,2879.7000000000003,1,4,3,4,11,High-Value
14252,1,350.99,380,1,1,2,4,At-Risk
14253,2,363.40000000000003,492,1,2,2,5,At-Risk
14254,1,601.03,432,1,1,2,4,At-Risk
14256,5,2460.79,259,2,3,4,9,High-Value
14257,9,5954.45,63,3,4,4,11,High-Value
14258,25,32051.34,8,4,4,4,12,High-Value
14259,1,120.0,141,2,1,1,4,One-Time
14260,3,824.28,470,1,2,2,5,At-Risk
14261,2,1163.45,50,3,2,3,8,Other
14262,8,2618.23,7,4,4,4,12,High-Value
14263,1,322.93,422,1,1,1,3,At-Risk
14264,6,1517.3600000000001,154,2,3,3,8,Other
14265,4,1373.35,108,2,3,3,8,Other
14266,1,40.56,427,1,1,1,3,At-Risk
14267,3,1516.24,162,2,2,3,7,Other
14268,1,354.85,470,1,1,2,4,At-Risk
14269,1,295.73,438,1,1,1,3,At-Risk
14270,1,492.65000000000003,331,2,1,2,5,Other
14271,2,214.18,225,2,2,1,5,Other
14272,4,920.8100000000001,73,3,3,3,9,High-Value
14273,4,559.97,50,3,3,2,8,Loyal
14274,1,256.6,685,1,1,1,3,At-Risk
14275,6,1189.3799999999999,395,1,3,3,7,At-Risk
14276,7,2102.68,98,2,4,3,9,High-Value
14277,8,16789.16,14,4,4,4,12,High-Value
14278,1,205.82999999999998,409,1,1,1,3,At-Risk
14279,2,191.86,520,1,2,1,4,At-Risk
14280,1,134.04,196,2,1,1,4,One-Time
14281,1,245.15,407,1,1,1,3,At-Risk
14282,25,7250.76,2,4,4,4,12,High-Value
14283,4,628.44,462,1,3,2,6,At-Risk
14284,3,1299.65,30,3,2,3,8,Other
14285,8,3284.42,20,4,4,4,12,High-Value
14286,7,8479.76,23,4,4,4,12,High-Value
14287,3,176.63,7,4,2,1,7,Other
14288,1,426.6,212,2,1,2,5,Other
14289,6,911.26,8,4,3,3,10,High-Value
14290,8,4516.56,10,4,4,4,12,High-Value
14291,23,7904.1,1,4,4,4,12,High-Value
14292,16,9226.25,7,4,4,4,12,High-Value
14293,9,2903.01,2,4,4,4,12,High-Value
14294,1,375.34000000000003,406,1,1,2,4,At-Risk
14295,4,2352.9100000000003,39,3,3,4,10,High-Value
14296,2,456.4,420,1,2,2,5,At-Risk
14297,4,1305.33,17,4,3,3,10,High-Value
14298,82,91194.49,7,4,4,4,12,High-Value
14299,27,14070.25,7,4,4,4,12,High-Value
14300,1,43.2,18,4,1,1,6,One-Time
14301,4,1992.18,116,2,3,3,8,Other
14302,3,742.9000000000001,430,1,2,2,5,At-Risk
14303,2,277.94,406,1,2,1,4,At-Risk
14304,3,1725.01,222,2,2,3,7,Other
14305,3,1858.96,70,3,2,3,8,Other
14306,6,3151.4,50,3,3,4,10,High-Value
14307,10,4287.92,88,3,4,4,11,High-Value
14309,11,3780.81,7,4,4,4,12,High-Value
14310,1,492.1,432,1,1,2,4,At-Risk
14311,2,516.45,242,2,2,2,6,Other
14312,11,3090.29,46,3,4,4,11,High-Value
14314,2,229.79999999999998,106,2,2,1,5,Other
14315,8,3197.82,44,3,4,4,11,High-Value
14316,5,1370.34,421,1,3,3,7,At-Risk
14317,1,508.58000000000004,64,3,1,2,6,Other
14318,1,158.02,459,1,1,1,3,At-Risk
14319,1,494.85,423,1,1,2,4,At-Risk
14320,5,1346.75,206,2,3,3,8,Other
14321,7,2218.06,10,4,4,3,11,High-Value
14322,4,474.1,428,1,3,2,6,At-Risk
14323,2,605.0600000000001,114,2,2,2,6,Other
14324,2,701.61,409,1,2,2,5,At-Risk
14325,1,245.48,569,1,1,1,3,At-Risk
14326,3,940.98,241,2,2,3,7,Other
14327,6,1894.93,162,2,3,3,8,Other
14329,15,9887.62,16,4,4,4,12,High-Value
14330,1,200.63,623,1,1,1,3,At-Risk
14331,2,462.65999999999997,123,2,2,2,6,Other
14332,5,1917.41,22,4,3,3,10,High-Value
14333,1,415.2,67,3,1,2,6,Other
14334,12,4318.4800000000005,16,4,4,4,12,High-Value
14335,2,454.86,15,4,2,2,8,Other
14336,4,1614.91,16,4,3,3,10,High-Value
14338,3,928.1,160,2,2,3,7,Other
14339,2,620.27,242,2,2,2,6,Other
14340,1,134.7,218,2,1,1,4,One-Time
14341,18,4452.02,44,3,4,4,11,High-Value
14342,6,918.44,20,4,3,3,10,High-Value
14343,4,1079.66,420,1,3,3,7,At-Risk
14344,20,2993.05,126,2,4,4,10,High-Value
14345,1,108.98,38,3,1,1,5,One-Time
14346,5,2315.75,120,2,3,4,9,High-Value
14347,1,82.6,736,1,1,1,3,At-Risk
14348,1,409.57,259,2,1,2,5,Other
14349,1,133.5,9,4,1,1,6,One-Time
14350,3,972.03,273,2,2,3,7,Other
14351,1,51.0,164,2,1,1,4,One-Time
14352,4,1078.96,156,2,3,3,8,Other
14353,3,376.5,214,2,2,2,6,Other
14354,2,163.62,5,4,2,1,7,Other
14355,3,840.0500000000001,365,2,2,2,6,Other
14356,2,701.23,79,3,2,2,7,Other
14357,1,225.12,42,3,1,1,5,One-Time
14358,2,400.06,388,1,2,2,5,At-Risk
14359,3,912.1800000000001,18,4,2,3,9,High-Value
14360,4,2118.03,31,3,3,3,9,High-Value
14361,1,214.71,578,1,1,1,3,At-Risk
14362,1,151.5,21,4,1,1,6,One-Time
14363,2,227.47000000000003,401,1,2,1,4,At-Risk
14364,8,3717.35,108,2,4,4,10,High-Value
14365,2,634.68,394,1,2,2,5,At-Risk
14366,1,136.0,524,1,1,1,3,At-Risk
14367,16,9227.82,7,4,4,4,12,High-Value
14368,1,155.0,319,2,1,1,4,One-Time
14369,2,469.13,641,1,2,2,5,At-Risk
14370,6,1175.78,450,1,3,3,7,At-Risk
14371,1,100.5,294,2,1,1,4,One-Time
14372,2,860.08,442,1,2,3,6,At-Risk
14373,1,76.55,357,2,1,1,4,One-Time
14374,1,108.0,540,1,1,1,3,At-Risk
14375,3,1106.82,184,2,2,3,7,Other
14376,1,215.46,682,1,1,1,3,At-Risk
14377,2,617.05,190,2,2,2,6,Other
14378,1,131.25,621,1,1,1,3,At-Risk
14379,4,1265.16,43,3,3,3,9,High-Value
14381,2,625.94,51,3,2,2,7,Other
14382,2,1193.6299999999999,25,3,2,3,8,Other
14383,3,1247.69,37,3,2,3,8,Other
14384,1,58.5,500,1,1,1,3,At-Risk
14385,3,202.11,8,4,2,1,7,Other
14386,1,142.4,296,2,1,1,4,One-Time
14387,3,1727.6000000000001,32,3,2,3,8,Other
14388,16,6388.2,9,4,4,4,12,High-Value
14389,5,1898.01,64,3,3,3,9,High-Value
14390,13,6150.03,9,4,4,4,12,High-Value
14391,1,135.6,576,1,1,1,3,At-Risk
14392,1,266.40000000000003,431,1,1,1,3,At-Risk
14393,1,67.95,217,2,1,1,4,One-Time
14394,1,93.8,564,1,1,1,3,At-Risk
14395,20,7801.93,1,4,4,4,12,High-Value
14396,7,1969.38,64,3,4,3,10,High-Value
14397,19,2612.96,2,4,4,4,12,High-Value
14398,2,707.7900000000001,400,1,2,2,5,At-Risk
14399,8,2108.21,393,1,4,3,8,At-Risk
14400,3,1732.47,148,2,2,3,7,Other
14401,22,6795.9,3,4,4,4,12,High-Value
14402,1,285.6,651,1,1,1,3,At-Risk
14403,6,1880.51,129,2,3,3,8,Other
14404,13,2724.13,33,3,4,4,11,High-Value
14405,1,195.0,386,1,1,1,3,At-Risk
14406,1,156.75,118,2,1,1,4,One-Time
14407,5,2142.73,106,2,3,3,8,Other
14408,11,4102.27,10,4,4,4,12,High-Value
14409,9,3427.29,70,3,4,4,11,High-Value
14410,11,2630.9,91,3,4,4,11,High-Value
14411,1,1063.0,310,2,1,3,6,Other
14412,3,1426.19,42,3,2,3,8,Other
14413,3,421.72,361,2,2,2,6,Other
14414,8,2399.33,91,3,4,4,11,High-Value
14415,23,11980.09,0,4,4,4,12,High-Value
14416,2,490.22,21,4,2,2,8,Other
14417,1,524.65,387,1,1,2,4,At-Risk
14418,3,1937.25,3,4,2,3,9,High-Value
14419,7,1254.64,10,4,4,3,11,High-Value
14420,4,1639.17,98,2,3,3,8,Other
14421,6,2469.37,56,3,3,4,10,High-Value
14422,19,10271.52,0,4,4,4,12,High-Value
14423,3,916.61,217,2,2,3,7,Other
14424,1,322.08,17,4,1,1,6,One-Time
14425,3,661.39,434,1,2,2,5,At-Risk
14426,17,11727.94,23,4,4,4,12,High-Value
14427,4,1263.52,49,3,3,3,9,High-Value
14428,5,1224.06,6,4,3,3,10,High-Value
14429,1,516.28,403,1,1,2,4,At-Risk
14430,3,1220.9,511,1,2,3,6,At-Risk
14431,4,2614.2,302,2,3,4,9,High-Value
14432,6,2248.5,9,4,3,4,11,High-Value
14433,1,280.7,465,1,1,1,3,At-Risk
14434,6,1372.8,21,4,3,3,10,High-Value
14435,1,90.41999999999999,501,1,1,1,3,At-Risk
14436,2,271.7,98,2,2,1,5,Other
14437,5,873.34,365,2,3,3,8,Other
14438,1,131.9,305,2,1,1,4,One-Time
14439,5,9443.04,319,2,3,4,9,High-Value
14440,13,5982.03,7,4,4,4,12,High-Value
14441,11,4611.69,0,4,4,4,12,High-Value
14442,7,5367.02,204,2,4,4,10,High-Value
14443,5,2082.9700000000003,53,3,3,3,9,High-Value
14444,1,120.44,455,1,1,1,3,At-Risk
14445,1,221.65,455,1,1,1,3,At-Risk
14446,5,1195.48,0,4,3,3,10,High-Value
14447,6,1711.73,18,4,3,3,10,High-Value
14448,2,375.35,8,4,2,2,8,Other
14449,8,2230.96,18,4,4,3,11,High-Value
14450,7,1128.44,180,2,4,3,9,High-Value
14451,12,3258.68,59,3,4,4,11,High-Value
14452,4,658.95,10,4,3,2,9,High-Value
14453,1,119.93,189,2,1,1,4,One-Time
14454,5,977.3,375,2,3,3,8,Other
14455,4,617.72,431,1,3,2,6,At-Risk
14456,9,3014.32,4,4,4,4,12,High-Value
14457,1,113.64,310,2,1,1,4,One-Time
14458,1,219.27,380,1,1,1,3,At-Risk
14459,2,5375.741,154,2,2,4,8,Other
14460,9,1093.5,109,2,4,3,9,High-Value
14461,13,6676.52,147,2,4,4,10,High-Value
14462,12,2237.81,65,3,4,3,10,High-Value
14463,4,786.5699999999999,97,2,3,2,7,Other
14464,2,111.0,567,1,2,1,4,At-Risk
14465,11,3925.85,246,2,4,4,10,High-Value
14466,13,4267.15,28,3,4,4,11,High-Value
14467,12,2203.2400000000002,17,4,4,3,11,High-Value
14468,1,204.24,733,1,1,1,3,At-Risk
14469,4,2093.46,415,1,3,3,7,At-Risk
14470,3,712.04,11,4,2,2,8,Other
14471,2,400.95,590,1,2,2,5,At-Risk
14472,9,2118.72,103,2,4,3,9,High-Value
14473,2,234.34,73,3,2,1,6,Other
14474,2,1258.89,45,3,2,3,8,Other
14475,4,1151.15,71,3,3,3,9,High-Value
14476,1,193.0,256,2,1,1,4,One-Time
14477,7,1969.6,19,4,4,3,11,High-Value
14478,4,1276.66,381,1,3,3,7,At-Risk
14479,4,1124.71,253,2,3,3,8,Other
14480,4,1299.52,10,4,3,3,10,High-Value
14481,5,2284.69,164,2,3,4,9,High-Value
14482,12,4306.72,17,4,4,4,12,High-Value
14483,2,257.1,281,2,2,1,5,Other
14484,4,1070.98,49,3,3,3,9,High-Value
14485,1,162.8,38,3,1,1,5,One-Time
14486,2,175.5,511,1,2,1,4,At-Risk
14487,7,1266.27,26,3,4,3,10,High-Value
14488,1,1064.28,67,3,1,3,7,Other
14489,4,1574.93,206,2,3,3,8,Other
14490,2,1273.47,405,1,2,3,6,At-Risk
14491,2,340.93,174,2,2,2,6,Other
14492,7,1921.91,429,1,4,3,8,At-Risk
14493,10,5087.86,6,4,4,4,12,High-Value
14494,3,401.46,25,3,2,2,7,Other
14495,3,174.8,50,3,2,1,6,Other
14496,7,2363.89,311,2,4,4,10,High-Value
14497,2,697.0600000000001,308,2,2,2,6,Other
14498,10,3900.83,42,3,4,4,11,High-Value
14499,7,2101.79,25,3,4,3,10,High-Value
14500,3,356.85,87,3,2,2,7,Other
14501,2,251.21,183,2,2,1,5,Other
14502,11,2426.79,19,4,4,4,12,High-Value
14503,6,3543.26,2,4,3,4,11,High-Value
14504,4,673.26,46,3,3,2,8,Loyal
14505,19,11873.08,16,4,4,4,12,High-Value
14506,7,2960.25,16,4,4,4,12,High-Value
14507,11,3216.74,23,4,4,4,12,High-Value
14508,5,822.92,21,4,3,2,9,High-Value
14509,1,110.95,533,1,1,1,3,At-Risk
14510,3,979.85,375,2,2,3,7,Other
14511,5,1314.81,10,4,3,3,10,High-Value
14512,7,1215.97,187,2,4,3,9,High-Value
14513,6,788.01,100,2,3,2,7,Other
14514,9,4380.04,60,3,4,4,11,High-Value
14515,12,3724.06,17,4,4,4,12,High-Value
14516,1,151.17,515,1,1,1,3,At-Risk
14517,2,330.45,32,3,2,1,6,Other
14518,1,174.37,63,3,1,1,5,One-Time
14519,2,203.14,683,1,2,1,4,At-Risk
14520,2,270.6,1,4,2,1,7,Other
14521,1,199.45,490,1,1,1,3,At-Risk
14522,8,1748.42,23,4,4,3,11,High-Value
14523,1,241.09,107,2,1,1,4,One-Time
14524,13,2909.86,31,3,4,4,11,High-Value
14525,17,8018.59,19,4,4,4,12,High-Value
14526,1,258.65,388,1,1,1,3,At-Risk
14527,121,27191.1,2,4,4,4,12,High-Value
14528,1,364.22,36,3,1,2,6,Other
14529,3,578.61,59,3,2,2,7,Other
14530,16,6088.87,25,3,4,4,11,High-Value
14531,1,376.34,479,1,1,2,4,At-Risk
14532,11,3845.78,235,2,4,4,10,High-Value
14533,11,3466.37,24,4,4,4,12,High-Value
14534,26,6183.06,2,4,4,4,12,High-Value
14535,9,5961.89,59,3,4,4,11,High-Value
14536,1,170.95,259,2,1,1,4,One-Time
14537,2,641.4,57,3,2,2,7,Other
14538,5,1370.8400000000001,64,3,3,3,9,High-Value
14539,2,537.48,15,4,2,2,8,Other
14540,11,3709.64,9,4,4,4,12,High-Value
14541,14,2491.38,58,3,4,4,11,High-Value
14542,1,103.25,185,2,1,1,4,One-Time
14543,39,14548.22,28,3,4,4,11,High-Value
14544,3,2938.53,23,4,2,4,10,High-Value
14545,1,349.25,673,1,1,2,4,At-Risk
14546,11,5184.84,4,4,4,4,12,High-Value
14547,8,3974.75,3,4,4,4,12,High-Value
14548,9,2541.29,150,2,4,4,10,High-Value
14549,4,913.6,310,2,3,3,8,Other
14550,4,1345.06,10,4,3,3,10,High-Value
14551,7,878.09,17,4,4,3,11,High-Value
14552,3,507.93,151,2,2,2,6,Other
14553,9,1818.6,18,4,4,3,11,High-Value
14554,4,2279.4900000000002,9,4,3,4,11,High-Value
14555,6,2304.03,56,3,3,4,10,High-Value
14556,3,815.69,595,1,2,2,5,At-Risk
14557,1,788.38,84,3,1,2,6,Other
14558,3,655.5,653,1,2,2,5,At-Risk
14559,1,75.6,389,1,1,1,3,At-Risk
14560,44,6114.03,6,4,4,4,12,High-Value
14561,3,1080.76,75,3,2,3,8,Other
14562,26,6638.150000000001,3,4,4,4,12,High-Value
14563,2,625.42,509,1,2,2,5,At-Risk
14564,2,2605.62,434,1,2,4,7,At-Risk
14565,5,3709.2200000000003,95,2,3,4,9,High-Value
14566,4,4092.0,110,2,3,4,9,High-Value
14567,2,1530.3600000000001,56,3,2,3,8,Other
14568,1,919.7,434,1,1,3,5,At-Risk
14569,4,597.33,0,4,3,2,9,High-Value
14570,3,512.4,280,2,2,2,6,Other
14571,1,160.0,424,1,1,1,3,At-Risk
14572,11,5520.9800000000005,2,4,4,4,12,High-Value
14573,13,2163.12,179,2,4,3,9,High-Value
14574,1,143.7,732,1,1,1,3,At-Risk
14575,1,420.21999999999997,487,1,1,2,4,At-Risk
14576,1,35.400000000000006,371,2,1,1,4,One-Time
14577,7,1364.15,12,4,4,3,11,High-Value
14578,1,168.63,2,4,1,1,6,One-Time
14579,1,105.56,431,1,1,1,3,At-Risk
14580,1,14.85,517,1,1,1,3,At-Risk
14581,2,409.65,16,4,2,2,8,Other
14582,1,114.11,40,3,1,1,5,One-Time
14583,8,1660.29,5,4,4,3,11,High-Value
14584,8,1738.16,168,2,4,3,9,High-Value
14585,5,1143.27,49,3,3,3,9,High-Value
14586,1,237.35999999999999,276,2,1,1,4,One-Time
14587,9,1580.29,18,4,4,3,11,High-Value
14588,1,135.39,577,1,1,1,3,At-Risk
14589,1,39.75,371,2,1,1,4,One-Time
14590,20,2993.37,424,1,4,4,9,High-Value
14591,4,1320.21,14,4,3,3,10,High-Value
14592,3,557.94,34,3,2,2,7,Other
14593,12,3658.03,21,4,4,4,12,High-Value
14594,2,363.33,6,4,2,2,8,Other
14595,8,2164.4500000000003,19,4,4,3,11,High-Value
14596,1,222.22,626,1,1,1,3,At-Risk
14597,6,2184.63,10,4,3,3,10,High-Value
14598,2,384.04,43,3,2,2,7,Other
14599,2,457.89,389,1,2,2,5,At-Risk
14600,2,865.17,305,2,2,3,7,Other
14601,1,213.96,10,4,1,1,6,One-Time
14602,1,205.35999999999999,655,1,1,1,3,At-Risk
14603,1,660.0,274,2,1,2,5,Other
14604,1,136.36,632,1,1,1,3,At-Risk
14605,4,920.71,373,2,3,3,8,Other
14606,184,29648.75,0,4,4,4,12,High-Value
14607,20,22575.13,15,4,4,4,12,High-Value
14608,10,3342.94,3,4,4,4,12,High-Value
14609,10,1486.2,71,3,4,3,10,High-Value
14610,2,24.35,395,1,2,1,4,At-Risk
14611,2,604.33,443,1,2,2,5,At-Risk
14612,1,877.7,414,1,1,3,5,At-Risk
14613,1,76.32000000000001,679,1,1,1,3,At-Risk
14614,1,295.13,385,1,1,1,3,At-Risk
14615,5,951.76,393,1,3,3,7,At-Risk
14616,5,527.78,242,2,3,2,7,Other
14617,2,190.47000000000003,402,1,2,1,4,At-Risk
14618,7,1342.32,8,4,4,3,11,High-Value
14619,2,1291.24,245,2,2,3,7,Other
14620,2,412.78000000000003,205,2,2,2,6,Other
14621,9,3000.57,0,4,4,4,12,High-Value
14622,1,320.58000000000004,184,2,1,1,4,One-Time
14623,10,2012.3,31,3,4,3,10,High-Value
14624,6,814.07,56,3,3,2,8,Loyal
14625,11,4497.88,195,2,4,4,10,High-Value
14626,11,5410.92,23,4,4,4,12,High-Value
14627,1,462.75,378,2,1,2,5,Other
14628,5,1998.0,90,3,3,3,9,High-Value
14629,2,955.26,3,4,2,3,9,High-Value
14630,1,338.65,483,1,1,1,3,At-Risk
14631,6,2025.69,50,3,3,3,9,High-Value
14632,1,114.56,262,2,1,1,4,One-Time
14633,1,344.90000000000003,265,2,1,2,5,Other
14634,4,2124.46,437,1,3,3,7,At-Risk
14635,1,215.22,453,1,1,1,3,At-Risk
14636,2,609.85,35,3,2,2,7,Other
14637,1,106.67999999999999,676,1,1,1,3,At-Risk
14638,1,443.6,50,3,1,2,6,Other
14639,9,4978.96,51,3,4,4,11,High-Value
14640,10,3649.36,23,4,4,4,12,High-Value
14641,1,110.46000000000001,21,4,1,1,6,One-Time
14642,1,96.12,58,3,1,1,5,One-Time
14643,5,1679.89,169,2,3,3,8,Other
14644,7,2247.72,67,3,4,4,11,High-Value
14645,3,876.89,156,2,2,3,7,Other
14646,145,526751.52,1,4,4,4,12,High-Value
14647,2,506.04,200,2,2,2,6,Other
14648,15,4463.39,415,1,4,4,9,High-Value
14649,9,3651.19,4,4,4,4,12,High-Value
14650,1,62.5,588,1,1,1,3,At-Risk
14651,9,2025.52,66,3,4,3,10,High-Value
14652,1,114.17999999999999,76,3,1,1,5,One-Time
14653,11,3404.8,0,4,4,4,12,High-Value
14654,1,246.86,737,1,1,1,3,At-Risk
14655,7,3878.51,7,4,4,4,12,High-Value
14656,5,790.0,168,2,3,2,7,Other
14657,6,1450.19,17,4,3,3,10,High-Value
14658,2,247.14999999999998,4,4,2,1,7,Other
14659,9,2529.93,8,4,4,4,12,High-Value
14660,2,285.74,86,3,2,1,6,Other
14661,1,107.95,26,3,1,1,5,One-Time
14662,7,1376.43,28,3,4,3,10,High-Value
14663,2,490.6,429,1,2,2,5,At-Risk
14664,2,636.24,19,4,2,2,8,Other
14665,7,2749.65,60,3,4,4,11,High-Value
14666,1,179.95,23,4,1,1,6,One-Time
14667,54,20359.59,10,4,4,4,12,High-Value
14668,1,111.63,444,1,1,1,3,At-Risk
14669,7,3216.78,241,2,4,4,10,High-Value
14670,3,583.33,279,2,2,2,6,Other
14671,2,1127.45,548,1,2,3,6,At-Risk
14672,4,1113.14,234,2,3,3,8,Other
14673,7,3037.32,2,4,4,4,12,High-Value
14674,1,173.66,508,1,1,1,3,At-Risk
14675,2,1015.58,15,4,2,3,9,High-Value
14676,12,8356.79,30,3,4,4,11,High-Value
14677,1,184.91,592,1,1,1,3,At-Risk
14678,1,403.39,578,1,1,2,4,At-Risk
14679,3,1289.44,381,1,2,3,6,At-Risk
14680,58,55688.5,24,4,4,4,12,High-Value
14681,6,875.1500000000001,70,3,3,3,9,High-Value
14682,6,1514.81,187,2,3,3,8,Other
14683,1,146.56,587,1,1,1,3,At-Risk
14684,6,1430.03,25,3,3,3,9,High-Value
14685,8,4536.64,575,1,4,4,9,High-Value
14686,5,852.53,413,1,3,2,6,At-Risk
14687,3,1402.06,106,2,2,3,7,Other
14688,28,7190.42,7,4,4,4,12,High-Value
14689,1,112.8,208,2,1,1,4,One-Time
14690,4,777.68,43,3,3,2,8,Loyal
14691,5,2114.33,30,3,3,3,9,High-Value
14692,12,1715.14,136,2,4,3,9,High-Value
14693,7,1165.3600000000001,264,2,4,3,9,High-Value
14694,1,244.31,616,1,1,1,3,At-Risk
14695,3,1534.22,518,1,2,3,6,At-Risk
14696,8,2473.28,3,4,4,4,12,High-Value
14697,2,188.61,217,2,2,1,5,Other
14698,5,1217.27,1,4,3,3,10,High-Value
14699,4,702.6,213,2,3,2,7,Other
14700,5,3076.06,31,3,3,4,10,High-Value
14701,15,4487.11,10,4,4,4,12,High-Value
14702,29,6356.9800000000005,0,4,4,4,12,High-Value
14703,1,318.17,14,4,1,1,6,One-Time
14704,9,1720.58,19,4,4,3,11,High-Value
14705,1,179.0,198,2,1,1,4,One-Time
14706,1,367.54,618,1,1,2,4,At-Risk
14707,2,139.2,435,1,2,1,4,At-Risk
14708,5,1793.22,2,4,3,3,10,High-Value
14709,25,8886.33,14,4,4,4,12,High-Value
14710,13,1899.79,13,4,4,3,11,High-Value
14711,11,2839.62,9,4,4,4,12,High-Value
14712,4,1328.07,28,3,3,3,9,High-Value
14713,21,5115.36,8,4,4,4,12,High-Value
14714,4,906.24,23,4,3,3,10,High-Value
14715,8,1809.55,24,4,4,3,11,High-Value
14716,3,543.28,42,3,2,2,7,Other
14717,1,81.3,732,1,1,1,3,At-Risk
14718,1,226.42,409,1,1,1,3,At-Risk
14719,5,1581.84,1,4,3,3,10,High-Value
14720,3,663.81,5,4,2,2,8,Other
14721,1,109.07,378,2,1,1,4,One-Time
14722,3,489.52,146,2,2,2,6,Other
14723,11,1801.36,9,4,4,3,11,High-Value
14724,1,341.9,589,1,1,2,4,At-Risk
14725,4,1246.86,24,4,3,3,10,High-Value
14726,1,116.5,654,1,1,1,3,At-Risk
14727,3,461.03000000000003,273,2,2,2,6,Other
14728,1,190.58,412,1,1,1,3,At-Risk
14729,3,586.24,373,2,2,2,6,Other
14730,8,1897.57,0,4,4,3,11,High-Value
14731,3,380.02,46,3,2,2,7,Other
14732,19,5517.07,7,4,4,4,12,High-Value
14733,15,14335.15,15,4,4,4,12,High-Value
14734,4,1056.42,425,1,3,3,7,At-Risk
14735,55,12225.16,3,4,4,4,12,High-Value
14736,2,374.05,484,1,2,2,5,At-Risk
14737,4,3554.17,3,4,3,4,11,High-Value
14738,9,1821.9,42,3,4,3,10,High-Value
14739,25,11573.62,3,4,4,4,12,High-Value
14740,11,4161.06,196,2,4,4,10,High-Value
14741,7,1713.0900000000001,11,4,4,3,11,High-Value
14742,1,579.85,434,1,1,2,4,At-Risk
14743,1,50.480000000000004,592,1,1,1,3,At-Risk
14744,14,3660.08,15,4,4,4,12,High-Value
14745,12,2551.41,112,2,4,4,10,High-Value
14746,4,593.5,405,1,3,2,6,At-Risk
14747,1,328.2,248,2,1,1,4,One-Time
14748,10,2681.9,28,3,4,4,11,High-Value
14749,1,310.15,479,1,1,1,3,At-Risk
14750,1,112.03,735,1,1,1,3,At-Risk
14751,2,126.45,683,1,2,1,4,At-Risk
14752,1,389.64,43,3,1,2,6,Other
14753,2,869.51,86,3,2,3,8,Other
14754,6,1547.93,44,3,3,3,9,High-Value
14755,25,9972.550000000001,9,4,4,4,12,High-Value
14756,3,2603.76,14,4,2,4,10,High-Value
14757,1,420.5,74,3,1,2,6,Other
14758,7,2864.9700000000003,144,2,4,4,10,High-Value
14759,3,1625.97,4,4,2,3,9,High-Value
14760,1,89.2,296,2,1,1,4,One-Time
14761,3,447.92,58,3,2,2,7,Other
14762,2,417.57,263,2,2,2,6,Other
14764,1,278.3,46,3,1,1,5,One-Time
14765,3,254.11,28,3,2,1,6,Other
14766,11,6375.7300000000005,7,4,4,4,12,High-Value
14767,1,382.81,473,1,1,2,4,At-Risk
14768,2,192.60000000000002,16,4,2,1,7,Other
14769,17,15512.460000000001,2,4,4,4,12,High-Value
14770,8,3637.6400000000003,231,2,4,4,10,High-Value
14771,2,594.62,620,1,2,2,5,At-Risk
14772,1,139.26,111,2,1,1,4,One-Time
14773,1,140.55,592,1,1,1,3,At-Risk
14774,1,241.45000000000002,528,1,1,1,3,At-Risk
14775,3,1011.9,57,3,2,3,8,Other
14776,15,3708.2999999999997,50,3,4,4,11,High-Value
14777,1,307.56,403,1,1,1,3,At-Risk
14778,2,730.86,126,2,2,2,6,Other
14779,3,386.15,280,2,2,2,6,Other
14780,2,447.68,54,3,2,2,7,Other
14782,1,200.10000000000002,319,2,1,1,4,One-Time
14783,1,307.3,658,1,1,1,3,At-Risk
14784,3,449.93,25,3,2,2,7,Other
14785,2,77.4,9,4,2,1,7,Other
14786,1,90.96,549,1,1,1,3,At-Risk
14787,1,110.65,470,1,1,1,3,At-Risk
14788,3,1156.32,6,4,2,3,9,High-Value
14789,1,197.64,28,3,1,1,5,One-Time
14790,10,2526.62,16,4,4,4,12,High-Value
14791,1,303.63,606,1,1,1,3,At-Risk
14792,1,6.2,63,3,1,1,5,One-Time
14793,2,625.9,20,4,2,2,8,Other
14794,10,1953.9,2,4,4,3,11,High-Value
14795,1,131.45000000000002,165,2,1,1,4,One-Time
14796,27,10167.77,0,4,4,4,12,High-Value
14797,1,300.31,506,1,1,1,3,At-Risk
14798,8,724.31,52,3,4,2,9,High-Value
14799,2,338.15,50,3,2,1,6,Other
14800,17,7180.08,47,3,4,4,11,High-Value
14801,1,189.34,60,3,1,1,5,One-Time
14803,3,845.5500000000001,161,2,2,2,6,Other
14804,1,353.27,8,4,1,2,7,Other
14805,7,1082.55,14,4,4,3,11,High-Value
14806,2,303.43,74,3,2,1,6,Other
14807,2,504.14000000000004,390,1,2,2,5,At-Risk
14808,8,2718.6,39,3,4,4,11,High-Value
14809,2,686.76,620,1,2,2,5,At-Risk
14810,13,2354.03,40,3,4,4,11,High-Value
14811,1,170.5,386,1,1,1,3,At-Risk
14812,1,178.85,598,1,1,1,3,At-Risk
14813,4,888.91,369,2,3,3,8,Other
14814,1,152.96,580,1,1,1,3,At-Risk
14815,2,778.5,36,3,2,2,7,Other
14816,1,271.85,196,2,1,1,4,One-Time
14817,7,3609.86,199,2,4,4,10,High-Value
14818,6,1153.56,73,3,3,3,9,High-Value
14819,4,456.40999999999997,63,3,3,2,8,Loyal
14820,9,1274.76,20,4,4,3,11,High-Value
14821,7,1230.15,366,2,4,3,9,High-Value
14822,1,157.7,484,1,1,1,3,At-Risk
14823,3,321.43,179,2,2,1,5,Other
14824,10,4022.9100000000003,9,4,4,4,12,High-Value
14825,24,4735.08,3,4,4,4,12,High-Value
14826,2,385.2,581,1,2,2,5,At-Risk
14828,13,9839.460000000001,196,2,4,4,10,High-Value
14829,7,1455.8700000000001,28,3,4,3,10,High-Value
14830,1,188.03,52,3,1,1,5,One-Time
14831,3,1676.57,679,1,2,3,6,At-Risk
14833,1,94.8,498,1,1,1,3,At-Risk
14834,7,2206.16,17,4,4,3,11,High-Value
14835,2,297.0,528,1,2,1,4,At-Risk
14836,3,102.45,9,4,2,1,7,Other
14837,9,3460.32,89,3,4,4,11,High-Value
14838,2,769.9200000000001,422,1,2,2,5,At-Risk
14839,3,915.28,417,1,2,3,6,At-Risk
14840,2,362.71,267,2,2,2,6,Other
14841,14,7163.0,52,3,4,4,11,High-Value
14842,4,2824.69,43,3,3,4,10,High-Value
14843,1,211.8,436,1,1,1,3,At-Risk
14844,10,6702.43,63,3,4,4,11,High-Value
14845,1,150.0,599,1,1,1,3,At-Risk
14846,1,437.4,426,1,1,2,4,At-Risk
14847,3,1348.95,148,2,2,3,7,Other
14848,1,310.56,404,1,1,1,3,At-Risk
14849,43,15407.61,21,4,4,4,12,High-Value
14850,7,1770.96,311,2,4,3,9,High-Value
14851,3,829.41,22,4,2,2,8,Other
14852,18,6132.43,57,3,4,4,11,High-Value
14853,5,1376.87,23,4,3,3,10,High-Value
14854,11,4303.06,77,3,4,4,11,High-Value
14855,7,6520.3,118,2,4,4,10,High-Value
14856,3,1290.53,35,3,2,3,8,Other
14857,7,3651.851,59,3,4,4,11,High-Value
14858,1,180.75,505,1,1,1,3,At-Risk
14859,5,1705.64,12,4,3,3,10,High-Value
14860,1,170.32,18,4,1,1,6,One-Time
14861,10,1380.73,51,3,4,3,10,High-Value
14862,2,841.2,25,3,2,2,7,Other
14863,1,266.76,28,3,1,1,5,One-Time
14865,4,92.52,6,4,3,1,8,Loyal
14866,17,20700.04,10,4,4,4,12,High-Value
14867,16,2952.06,185,2,4,4,10,High-Value
14868,12,4184.01,2,4,4,4,12,High-Value
14869,6,2778.14,8,4,3,4,11,High-Value
14870,6,1838.95,261,2,3,3,8,Other
14871,9,1228.17,2,4,4,3,11,High-Value
14872,3,816.6,483,1,2,2,5,At-Risk
14873,2,854.13,209,2,2,2,6,Other
14874,1,116.18,534,1,1,1,3,At-Risk
14875,3,2862.4,107,2,2,4,8,Other
14876,2,256.7,520,1,2,1,4,At-Risk
14877,2,425.85,417,1,2,2,5,At-Risk
14878,25,4076.5,12,4,4,4,12,High-Value
14879,1,185.06,684,1,1,1,3,At-Risk
14880,3,690.59,76,3,2,2,7,Other
14881,1,255.4,19,4,1,1,6,One-Time
14882,14,3546.65,26,3,4,4,11,High-Value
14883,6,761.59,18,4,3,2,9,High-Value
14884,1,120.6,668,1,1,1,3,At-Risk
14885,3,1598.12,131,2,2,3,7,Other
14886,1,364.8,252,2,1,2,5,Other
14887,1,1862.0,78,3,1,3,7,Other
14888,1,369.2,206,2,1,2,5,Other
14889,1,135.9,335,2,1,1,4,One-Time
14890,3,817.25,253,2,2,2,6,Other
14891,4,1106.73,147,2,3,3,8,Other
14892,1,202.35000000000002,690,1,1,1,3,At-Risk
14893,3,1809.6100000000001,9,4,2,3,9,High-Value
14894,3,1492.81,84,3,2,3,8,Other
14895,38,25119.54,7,4,4,4,12,High-Value
14896,8,1826.0,204,2,4,3,9,High-Value
14897,8,3140.54,7,4,4,4,12,High-Value
14898,14,3365.95,22,4,4,4,12,High-Value
14899,1,1331.38,394,1,1,3,5,At-Risk
14900,1,13.919999999999998,521,1,1,1,3,At-Risk
14901,12,1919.0,10,4,4,3,11,High-Value
14902,3,1035.6200000000001,25,3,2,3,8,Other
14903,5,2795.33,20,4,3,4,11,High-Value
14904,4,1630.49,1,4,3,3,10,High-Value
14905,8,1971.39,157,2,4,3,9,High-Value
14907,16,5547.72,2,4,4,4,12,High-Value
14908,2,381.9,73,3,2,2,7,Other
14909,3,1404.68,436,1,2,3,6,At-Risk
14910,4,434.35,2,4,3,2,9,High-Value
14911,373,272252.79,0,4,4,4,12,High-Value
14912,5,1849.58,16,4,3,3,10,High-Value
14913,8,4073.13,35,3,4,4,11,High-Value
14915,11,1811.25,90,3,4,3,10,High-Value
14916,8,3042.95,70,3,4,4,11,High-Value
14917,2,1123.75,596,1,2,3,6,At-Risk
14918,9,5955.81,115,2,4,4,10,High-Value
14919,1,359.35,538,1,1,2,4,At-Risk
14920,3,1607.17,212,2,2,3,7,Other
14921,2,1316.07,29,3,2,3,8,Other
14922,2,843.74,393,1,2,2,5,At-Risk
14923,1,749.1,50,3,1,2,6,Other
14924,3,931.01,245,2,2,3,7,Other
14926,2,359.4,381,1,2,2,5,At-Risk
14927,1,308.2,396,1,1,1,3,At-Risk
14928,1,223.91000000000003,627,1,1,1,3,At-Risk
14929,2,836.69,31,3,2,2,7,Other
14930,6,5236.7300000000005,108,2,3,4,9,High-Value
14931,4,864.6800000000001,4,4,3,3,10,High-Value
14932,2,566.13,365,2,2,2,6,Other
14933,4,1770.0,443,1,3,3,7,At-Risk
14934,5,3403.5,81,3,3,4,10,High-Value
14935,2,2849.83,296,2,2,4,8,Other
14936,12,12410.81,33,3,4,4,11,High-Value
14937,3,1621.88,56,3,2,3,8,Other
14938,2,2322.43,561,1,2,4,7,At-Risk
14940,2,531.49,417,1,2,2,5,At-Risk
14941,1,182.10000000000002,578,1,1,1,3,At-Risk
14942,4,746.56,401,1,3,2,6,At-Risk
14943,1,107.62,662,1,1,1,3,At-Risk
14944,19,9684.67,29,3,4,4,11,High-Value
14945,1,179.4,413,1,1,1,3,At-Risk
14946,1,100.9,13,4,1,1,6,One-Time
14947,6,1049.79,71,3,3,3,9,High-Value
14948,6,1101.97,22,4,3,3,10,High-Value
14949,4,515.0,468,1,3,2,6,At-Risk
14950,1,371.2,18,4,1,2,7,Other
14951,1,311.69,78,3,1,1,5,One-Time
14952,32,17629.35,59,3,4,4,11,High-Value
14953,4,968.82,24,4,3,3,10,High-Value
14954,2,462.12,11,4,2,2,8,Other
14955,1,163.77,732,1,1,1,3,At-Risk
14956,1,1325.0,420,1,1,3,5,At-Risk
14957,2,261.69,252,2,2,1,5,Other
14958,6,941.99,146,2,3,3,8,Other
14959,4,695.42,63,3,3,2,8,Loyal
14960,2,221.26999999999998,7,4,2,1,7,Other
14961,22,16410.15,10,4,4,4,12,High-Value
14962,4,366.91,270,2,3,2,7,Other
14963,12,3123.57,9,4,4,4,12,High-Value
14964,1,206.21,246,2,1,1,4,One-Time
14965,2,596.09,95,2,2,2,6,Other
14966,6,1064.26,14,4,3,3,10,High-Value
14967,6,1982.6100000000001,49,3,3,3,9,High-Value
14968,2,497.49,29,3,2,2,7,Other
14969,1,906.23,703,1,1,3,5,At-Risk
14970,12,4919.35,67,3,4,4,11,High-Value
14971,3,1097.98,34,3,2,3,8,Other
14972,2,145.07,127,2,2,1,5,Other
14973,3,1314.45,106,2,2,3,7,Other
14974,1,89.94,36,3,1,1,5,One-Time
14975,2,472.39,56,3,2,2,7,Other
14976,6,774.86,56,3,3,2,8,Loyal
14977,1,31.93,725,1,1,1,3,At-Risk
14978,10,3112.19,71,3,4,4,11,High-Value
14979,1,429.66,734,1,1,2,4,At-Risk
14980,1,150.68,736,1,1,1,3,At-Risk
14981,2,372.92,245,2,2,2,6,Other
14982,1,234.88,571,1,1,1,3,At-Risk
14983,1,183.20000000000002,688,1,1,1,3,At-Risk
14984,6,1260.51,18,4,3,3,10,High-Value
14985,2,292.01,197,2,2,1,5,Other
14986,2,563.1,375,2,2,2,6,Other
14987,8,1550.6499999999999,15,4,4,3,11,High-Value
14988,7,2038.65,211,2,4,3,9,High-Value
14989,1,342.4,661,1,1,2,4,At-Risk
14990,2,304.17,611,1,2,1,4,At-Risk
14991,1,314.67,429,1,1,1,3,At-Risk
14992,1,210.5,441,1,1,1,3,At-Risk
14993,1,36.13,563,1,1,1,3,At-Risk
14994,5,942.77,381,1,3,3,7,At-Risk
14995,2,231.98000000000002,38,3,2,1,6,Other
14996,2,442.29,480,1,2,2,5,At-Risk
14997,4,776.6,45,3,3,2,8,Loyal
14998,4,753.18,169,2,3,2,7,Other
14999,1,129.48,592,1,1,1,3,At-Risk
15000,1,490.52,47,3,1,2,6,Other
15001,2,197.10999999999999,393,1,2,1,4,At-Risk
15002,9,4138.08,115,2,4,4,10,High-Value
15003,6,1027.03,472,1,3,3,7,At-Risk
15004,1,1220.38,146,2,1,3,6,Other
15005,56,13752.58,15,4,4,4,12,High-Value
15006,2,752.83,50,3,2,2,7,Other
15007,1,156.91,158,2,1,1,4,One-Time
15008,2,360.0,479,1,2,2,5,At-Risk
15009,3,1259.43,11,4,2,3,9,High-Value
15010,1,308.94,35,3,1,1,5,One-Time
15011,2,416.6,395,1,2,2,5,At-Risk
15012,3,646.26,53,3,2,2,7,Other
15013,10,1610.82,487,1,4,3,8,At-Risk
15014,2,257.67,42,3,2,1,6,Other
15015,13,2344.47,500,1,4,4,9,High-Value
15016,5,620.89,172,2,3,2,7,Other
15017,1,125.58,33,3,1,1,5,One-Time
15018,3,496.21000000000004,38,3,2,2,7,Other
15019,1,252.81,266,2,1,1,4,One-Time
15020,1,198.47,378,2,1,1,4,One-Time
15021,12,2500.59,8,4,4,4,12,High-Value
15022,5,1133.44,11,4,3,3,10,High-Value
15023,20,11555.5,2,4,4,4,12,High-Value
15024,16,3559.39,9,4,4,4,12,High-Value
15025,2,971.84,32,3,2,3,8,Other
15026,5,1044.09,79,3,3,3,9,High-Value
15027,10,3195.6,30,3,4,4,11,High-Value
15028,6,962.94,7,4,3,3,10,High-Value
15029,1,365.1,619,1,1,2,4,At-Risk
15030,8,1979.91,71,3,4,3,10,High-Value
15031,14,3102.94,3,4,4,4,12,High-Value
15032,8,11010.05,255,2,4,4,10,High-Value
15033,10,2553.88,4,4,4,4,12,High-Value
15034,14,8231.2,15,4,4,4,12,High-Value
15035,1,252.73000000000002,89,3,1,1,5,One-Time
15036,3,429.56,71,3,2,2,7,Other
15037,2,397.76,375,2,2,2,6,Other
15038,9,1146.53,58,3,4,3,10,High-Value
15039,93,39141.48,9,4,4,4,12,High-Value
15040,1,7.49,541,1,1,1,3,At-Risk
15041,2,288.98,169,2,2,1,5,Other
15042,2,315.45000000000005,198,2,2,1,5,Other
15043,6,2855.3199999999997,30,3,3,4,10,High-Value
15044,32,15769.01,18,4,4,4,12,High-Value
15045,2,735.66,151,2,2,2,6,Other
15046,25,7604.84,8,4,4,4,12,High-Value
15047,1,343.62,269,2,1,2,5,Other
15048,4,381.0,64,3,3,2,8,Loyal
15049,1,121.17000000000002,273,2,1,1,4,One-Time
15050,5,4087.19,24,4,3,4,11,High-Value
15051,9,3926.91,22,4,4,4,12,High-Value
15052,1,207.73000000000002,318,2,1,1,4,One-Time
15053,3,693.95,4,4,2,2,8,Other
15054,2,302.1,11,4,2,1,7,Other
15055,3,549.12,474,1,2,2,5,At-Risk
15056,1,113.65,519,1,1,1,3,At-Risk
15057,5,3255.96,274,2,3,4,9,High-Value
15058,16,3387.58,24,4,4,4,12,High-Value
15059,19,3490.4,40,3,4,4,11,High-Value
15060,4,293.0,7,4,3,1,8,Loyal
15061,127,126387.56999999999,3,4,4,4,12,High-Value
15062,8,2585.62,70,3,4,4,11,High-Value
15063,1,370.79999999999995,212,2,1,2,5,Other
15064,4,1154.41,409,1,3,3,7,At-Risk
15065,5,3326.86,37,3,3,4,10,High-Value
15066,1,893.59,52,3,1,3,7,Other
15067,5,3862.88,77,3,3,4,10,High-Value
15068,4,1174.9,45,3,3,3,9,High-Value
15069,1,1109.53,178,2,1,3,6,Other
15070,3,737.05,372,2,2,2,6,Other
15071,4,1455.56,93,3,3,3,9,High-Value
15072,1,187.52,478,1,1,1,3,At-Risk
15073,8,2788.02,9,4,4,4,12,High-Value
15074,3,1553.13,104,2,2,3,7,Other
15075,1,773.03,77,3,1,2,6,Other
15076,3,1447.74,172,2,2,3,7,Other
15077,2,2428.08,494,1,2,4,7,At-Risk
15078,52,17276.73,6,4,4,4,12,High-Value
15079,11,3625.4,212,2,4,4,10,High-Value
15080,2,546.25,427,1,2,2,5,At-Risk
15081,12,1854.57,21,4,4,3,11,High-Value
15082,1,93.35000000000001,668,1,1,1,3,At-Risk
15083,1,88.2,256,2,1,1,4,One-Time
15084,2,965.1999999999999,379,1,2,3,6,At-Risk
15085,1,347.54,729,1,1,2,4,At-Risk
15086,2,218.53,564,1,2,1,4,At-Risk
15087,1,306.94,281,2,1,1,4,One-Time
15088,2,1160.07,20,4,2,3,9,High-Value
15089,6,2420.84,9,4,3,4,11,High-Value
15090,1,381.32,307,2,1,2,5,Other
15091,3,1046.61,67,3,2,3,8,Other
15092,3,776.46,214,2,2,2,6,Other
15093,23,13702.380000000001,17,4,4,4,12,High-Value
15094,2,83.0,462,1,2,1,4,At-Risk
15095,10,3141.64,103,2,4,4,10,High-Value
15096,1,219.39000000000001,42,3,1,1,5,One-Time
15097,3,908.35,3,4,2,3,9,High-Value
15098,3,39916.5,181,2,2,4,8,Other
15099,1,410.48,83,3,1,2,6,Other
15100,7,2193.9,333,2,4,3,9,High-Value
15101,6,1477.94,8,4,3,3,10,High-Value
15102,2,554.67,530,1,2,2,5,At-Risk
15103,2,703.36,30,3,2,2,7,Other
15104,2,993.54,196,2,2,3,7,Other
15105,9,3094.91,17,4,4,4,12,High-Value
15106,5,1422.52,17,4,3,3,10,High-Value
15107,9,824.35,310,2,4,2,8,Other
15108,3,1159.25,141,2,2,3,7,Other
15109,3,983.1,245,2,2,3,7,Other
15110,6,1505.8500000000001,23,4,3,3,10,High-Value
15111,5,2442.37,28,3,3,4,10,High-Value
15112,1,209.4,610,1,1,1,3,At-Risk
15113,3,3509.04,9,4,2,4,10,High-Value
15114,12,3400.12,29,3,4,4,11,High-Value
15115,2,531.85,17,4,2,2,8,Other
15116,4,1352.75,17,4,3,3,10,High-Value
15117,8,2485.97,14,4,4,4,12,High-Value
15118,1,244.8,133,2,1,1,4,One-Time
15119,1,266.4,245,2,1,1,4,One-Time
15120,1,358.82,133,2,1,2,5,Other
15121,2,457.72,49,3,2,2,7,Other
15122,11,4487.27,113,2,4,4,10,High-Value
15123,5,4656.17,6,4,3,4,11,High-Value
15124,4,450.82,22,4,3,2,9,High-Value
15125,24,17024.87,24,4,4,4,12,High-Value
15126,2,449.49,536,1,2,2,5,At-Risk
15127,2,711.5,65,3,2,2,7,Other
15128,5,1783.68,59,3,3,3,9,High-Value
15129,23,6860.18,49,3,4,4,11,High-Value
15130,1,330.11,169,2,1,1,4,One-Time
15131,1,80.28,394,1,1,1,3,At-Risk
15132,5,977.9300000000001,17,4,3,3,10,High-Value
15133,5,1806.9,127,2,3,3,8,Other
15134,10,1596.29,14,4,4,3,11,High-Value
15135,2,305.68,238,2,2,1,5,Other
15136,4,1286.7,2,4,3,3,10,High-Value
15137,2,823.4,520,1,2,2,5,At-Risk
15138,1,502.52,393,1,1,2,4,At-Risk
15139,2,178.96,239,2,2,1,5,Other
15140,8,3243.69,51,3,4,4,11,High-Value
15141,7,1388.47,457,1,4,3,8,At-Risk
15142,6,2619.92,45,3,3,4,10,High-Value
15143,2,563.63,225,2,2,2,6,Other
15144,29,12160.31,7,4,4,4,12,High-Value
15145,4,1194.73,3,4,3,3,10,High-Value
15146,2,1327.16,164,2,2,3,7,Other
15147,1,623.5,239,2,1,2,5,Other
15148,1,301.29,10,4,1,1,6,One-Time
15149,4,1524.6100000000001,133,2,3,3,8,Other
15150,13,8977.94,16,4,4,4,12,High-Value
15151,2,2085.61,422,1,2,3,6,At-Risk
15152,14,5263.83,9,4,4,4,12,High-Value
15153,1,329.25,30,3,1,1,5,One-Time
15154,3,1343.72,74,3,2,3,8,Other
15155,1,383.96999999999997,382,1,1,2,4,At-Risk
15156,3,961.49,0,4,2,3,9,High-Value
15157,5,2654.11,3,4,3,4,11,High-Value
15158,2,606.02,44,3,2,2,7,Other
15159,34,22116.73,1,4,4,4,12,High-Value
15160,4,589.27,356,2,3,2,7,Other
15161,1,119.92,387,1,1,1,3,At-Risk
15162,1,312.9,730,1,1,1,3,At-Risk
15163,2,304.47,17,4,2,1,7,Other
15164,9,2028.1100000000001,68,3,4,3,10,High-Value
15165,1,487.75,372,2,1,2,5,Other
15166,1,167.16,467,1,1,1,3,At-Risk
15167,5,1627.62,320,2,3,3,8,Other
15168,1,106.56,25,3,1,1,5,One-Time
15169,2,569.22,381,1,2,2,5,At-Risk
15170,1,81.15,406,1,1,1,3,At-Risk
15171,1,1289.5,330,2,1,3,6,Other
15172,5,1624.05,8,4,3,3,10,High-Value
15173,7,1494.6,380,1,4,3,8,At-Risk
15174,2,481.46,322,2,2,2,6,Other
15175,1,224.14,71,3,1,1,5,One-Time
15176,1,988.0400000000001,667,1,1,3,5,At-Risk
15177,1,948.9300000000001,425,1,1,3,5,At-Risk
15178,1,40.5,259,2,1,1,4,One-Time
15179,13,7491.92,17,4,4,4,12,High-Value
15180,3,816.9300000000001,366,2,2,2,6,Other
15181,5,1200.2,65,3,3,3,9,High-Value
15182,11,2998.952,153,2,4,4,10,High-Value
15183,3,639.9300000000001,547,1,2,2,5,At-Risk
15184,4,685.39,28,3,3,2,8,Loyal
15185,1,310.62,69,3,1,1,5,One-Time
15186,5,1403.2,13,4,3,3,10,High-Value
15187,15,4762.18,1,4,4,4,12,High-Value
15188,1,310.43,724,1,1,1,3,At-Risk
15189,46,17524.38,0,4,4,4,12,High-Value
15190,1,834.4399999999999,433,1,1,2,4,At-Risk
15191,3,588.05,462,1,2,2,5,At-Risk
15192,5,1666.39,119,2,3,3,8,Other
15193,1,499.32,60,3,1,2,6,Other
15194,28,12021.53,2,4,4,4,12,High-Value
15195,1,3861.0,2,4,1,4,9,High-Value
15196,2,313.7,432,1,2,1,4,At-Risk
15197,6,1877.51,10,4,3,3,10,High-Value
15198,5,571.35,91,3,3,2,8,Loyal
15199,10,3122.4,58,3,4,4,11,High-Value
15200,1,549.0500000000001,494,1,1,2,4,At-Risk
15201,7,1842.95,86,3,4,3,10,High-Value
15203,15,4400.18,25,3,4,4,11,High-Value
15204,1,316.58,356,2,1,1,4,One-Time
15205,2,653.24,84,3,2,2,7,Other
15206,4,420.3,9,4,3,2,9,High-Value
15207,3,683.92,415,1,2,2,5,At-Risk
15208,6,970.52,0,4,3,3,10,High-Value
15209,1,178.98000000000002,729,1,1,1,3,At-Risk
15210,3,1176.19,224,2,2,3,7,Other
15211,2,894.4100000000001,59,3,2,3,8,Other
15212,2,208.28,240,2,2,1,5,Other
15213,2,328.35,318,2,2,1,5,Other
15214,8,1661.44,1,4,4,3,11,High-Value
15215,7,2422.43,46,3,4,4,11,High-Value
15216,2,486.09000000000003,87,3,2,2,7,Other
15217,1,426.24,562,1,1,2,4,At-Risk
15218,22,11453.83,10,4,4,4,12,High-Value
15219,2,685.45,175,2,2,2,6,Other
15220,6,1778.96,51,3,3,3,9,High-Value
15221,4,2062.2,365,2,3,3,8,Other
15222,11,3550.91,318,2,4,4,10,High-Value
15223,5,1417.95,225,2,3,3,8,Other
15224,5,871.36,357,2,3,3,8,Other
15225,1,409.40000000000003,233,2,1,2,5,Other
15226,1,154.41,310,2,1,1,4,One-Time
15227,9,2488.4900000000002,36,3,4,4,11,High-Value
15228,6,5580.27,65,3,3,4,10,High-Value
15229,1,160.5,585,1,1,1,3,At-Risk
15230,2,429.6,238,2,2,2,6,Other
15231,1,250.26000000000002,620,1,1,1,3,At-Risk
15232,2,612.06,112,2,2,2,6,Other
15233,1,59.400000000000006,400,1,1,1,3,At-Risk
15234,1,197.0,276,2,1,1,4,One-Time
15235,16,2772.76,217,2,4,4,10,High-Value
15236,1,321.05,298,2,1,1,4,One-Time
15237,4,1412.32,1,4,3,3,10,High-Value
15238,3,1071.99,28,3,2,3,8,Other
15239,2,780.59,9,4,2,2,8,Other
15240,12,4459.9800000000005,44,3,4,4,11,High-Value
15241,11,3050.16,66,3,4,4,11,High-Value
15242,1,302.04,421,1,1,1,3,At-Risk
15243,2,927.28,73,3,2,3,8,Other
15244,3,912.08,64,3,2,3,8,Other
15245,8,4610.84,133,2,4,4,10,High-Value
15246,3,780.4,237,2,2,2,6,Other
15247,3,976.06,121,2,2,3,7,Other
15248,3,1893.93,410,1,2,3,6,At-Risk
15249,18,9266.0,31,3,4,4,11,High-Value
15250,1,60.0,640,1,1,1,3,At-Risk
15251,21,20324.54,8,4,4,4,12,High-Value
15252,5,2103.41,35,3,3,3,9,High-Value
15253,8,2055.09,15,4,4,3,11,High-Value
15254,3,1088.35,126,2,2,3,7,Other
15255,9,3706.02,66,3,4,4,11,High-Value
15256,2,170.4,148,2,2,1,5,Other
15257,2,685.9,282,2,2,2,6,Other
15258,2,623.16,168,2,2,2,6,Other
15259,4,1182.38,512,1,3,3,7,At-Risk
15260,25,8767.73,99,2,4,4,10,High-Value
15261,4,1508.0,134,2,3,3,8,Other
15262,3,418.82,323,2,2,2,6,Other
15263,1,156.51,106,2,1,1,4,One-Time
15264,2,848.4,63,3,2,2,7,Other
15265,4,3345.64,150,2,3,4,9,High-Value
15266,5,852.21,337,2,3,2,7,Other
15267,5,1717.36,21,4,3,3,10,High-Value
15268,3,961.9000000000001,478,1,2,3,6,At-Risk
15269,3,1225.36,23,4,2,3,9,High-Value
15270,21,8524.86,15,4,4,4,12,High-Value
15271,24,4528.54,6,4,4,4,12,High-Value
15272,6,2030.95,56,3,3,3,9,High-Value
15273,1,228.96,599,1,1,1,3,At-Risk
15274,2,716.57,3,4,2,2,8,Other
15275,1,615.14,37,3,1,2,6,Other
15276,4,619.8,65,3,3,2,8,Loyal
15277,2,476.34,46,3,2,2,7,Other
15278,4,496.16,561,1,3,2,6,At-Risk
15279,5,1580.54,354,2,3,3,8,Other
15280,3,397.52,171,2,2,2,6,Other
15281,16,8543.57,58,3,4,4,11,High-Value
15282,1,348.59,569,1,1,2,4,At-Risk
15283,3,148.32999999999998,389,1,2,1,4,At-Risk
15284,1,24.75,499,1,1,1,3,At-Risk
15285,1,94.91999999999999,407,1,1,1,3,At-Risk
15286,1,240.55,49,3,1,1,5,One-Time
15287,5,856.03,21,4,3,3,10,High-Value
15288,10,3706.53,42,3,4,4,11,High-Value
15289,5,1593.0900000000001,28,3,3,3,9,High-Value
15290,26,10496.28,4,4,4,4,12,High-Value
15291,39,13472.76,25,3,4,4,11,High-Value
15292,1,178.39,200,2,1,1,4,One-Time
15293,1,247.5,665,1,1,1,3,At-Risk
15294,1,233.35000000000002,410,1,1,1,3,At-Risk
15295,1,207.04,653,1,1,1,3,At-Risk
15296,12,10323.03,50,3,4,4,11,High-Value
15297,3,641.94,9,4,2,2,8,Other
15298,23,9061.77,1,4,4,4,12,High-Value
15299,9,5556.53,66,3,4,4,11,High-Value
15300,1,496.44,63,3,1,2,6,Other
15301,17,6909.67,50,3,4,4,11,High-Value
15302,1,308.0,729,1,1,1,3,At-Risk
15303,3,1224.18,289,2,2,3,7,Other
15304,9,796.4000000000001,60,3,4,2,9,High-Value
15305,1,93.6,554,1,1,1,3,At-Risk
15306,9,3484.73,63,3,4,4,11,High-Value
15307,1,205.3,95,2,1,1,4,One-Time
15308,1,310.47,273,2,1,1,4,One-Time
15309,4,797.96,610,1,3,2,6,At-Risk
15310,1,1634.64,478,1,1,3,5,At-Risk
15311,207,114671.42,0,4,4,4,12,High-Value
15312,12,2930.19,74,3,4,4,11,High-Value
15313,1,52.0,109,2,1,1,4,One-Time
15314,3,820.45,198,2,2,2,6,Other
15315,2,570.5,63,3,2,2,7,Other
15316,1,165.0,326,2,1,1,4,One-Time
15317,1,129.75,676,1,1,1,3,At-Risk
15318,1,312.62,3,4,1,1,6,One-Time
15319,1,204.5,283,2,1,1,4,One-Time
15320,1,267.13,43,3,1,1,5,One-Time
15321,12,6709.7300000000005,70,3,4,4,11,High-Value
15322,2,1390.86,85,3,2,3,8,Other
15323,3,434.6,562,1,2,2,5,At-Risk
15324,1,140.22000000000003,700,1,1,1,3,At-Risk
15325,8,1601.46,103,2,4,3,9,High-Value
15326,5,1700.52,333,2,3,3,8,Other
15327,1,208.75,52,3,1,1,5,One-Time
15328,1,107.24000000000001,407,1,1,1,3,At-Risk
15329,11,2958.83,38,3,4,4,11,High-Value
15330,2,714.9599999999999,31,3,2,2,7,Other
15331,3,767.91,499,1,2,2,5,At-Risk
15332,6,4892.68,365,2,3,4,9,High-Value
15333,1,1028.56,207,2,1,3,6,Other
15334,3,347.87,156,2,2,2,6,Other
15335,1,170.22,53,3,1,1,5,One-Time
15336,1,240.5,401,1,1,1,3,At-Risk
15337,1,373.02,410,1,1,2,4,At-Risk
15338,1,277.93,676,1,1,1,3,At-Risk
15339,7,1821.02,65,3,4,3,10,High-Value
15340,1,105.5,561,1,1,1,3,At-Risk
15341,2,2402.72,80,3,2,4,9,High-Value
15342,1,406.09000000000003,129,2,1,2,5,Other
15343,1,364.5,86,3,1,2,6,Other
15344,3,563.94,0,4,2,2,8,Other
15345,1,393.54,45,3,1,2,6,Other
15346,3,596.12,332,2,2,2,6,Other
15347,4,1162.0,365,2,3,3,8,Other
15348,1,158.04,71,3,1,1,5,One-Time
15349,2,463.90999999999997,157,2,2,2,6,Other
15350,2,547.6,372,2,2,2,6,Other
15351,10,3430.22,11,4,4,4,12,High-Value
15352,1,111.15,548,1,1,1,3,At-Risk
15353,7,2794.4700000000003,254,2,4,4,10,High-Value
15355,2,277.05,28,3,2,1,6,Other
15356,13,3239.57,30,3,4,4,11,High-Value
15358,42,16425.86,4,4,4,4,12,High-Value
15359,8,181.35,662,1,4,1,6,At-Risk
15360,1,427.93,39,3,1,2,6,Other
15361,4,689.07,361,2,3,2,7,Other
15362,2,613.08,448,1,2,2,5,At-Risk
15363,2,678.11,372,2,2,2,6,Other
15364,2,913.19,95,2,2,3,7,Other
15365,13,4557.13,25,3,4,4,11,High-Value
15366,7,2389.08,74,3,4,4,11,High-Value
15367,11,5081.33,56,3,4,4,11,High-Value
15368,2,722.74,20,4,2,2,8,Other
15369,11,6251.26,491,1,4,4,9,High-Value
15370,8,3739.01,40,3,4,4,11,High-Value
15371,1,59.400000000000006,661,1,1,1,3,At-Risk
15372,8,6017.06,136,2,4,4,10,High-Value
15373,17,3084.54,7,4,4,4,12,High-Value
15374,2,307.32,128,2,2,1,5,Other
15375,1,60.96,689,1,1,1,3,At-Risk
15376,3,1221.56,39,3,2,3,8,Other
15377,4,1211.75,382,1,3,3,7,At-Risk
15378,2,246.5,462,1,2,1,4,At-Risk
15379,8,4877.84,168,2,4,4,10,High-Value
15380,11,3248.96,8,4,4,4,12,High-Value
15381,5,1890.57,213,2,3,3,8,Other
15382,12,13733.550000000001,14,4,4,4,12,High-Value
15384,4,2027.79,169,2,3,3,8,Other
15385,3,942.08,39,3,2,3,8,Other
15386,1,394.14,185,2,1,2,5,Other
15387,1,468.65,491,1,1,2,4,At-Risk
15388,1,140.54,269,2,1,1,4,One-Time
15389,5,2733.8,171,2,3,4,9,High-Value
15390,2,1216.66,395,1,2,3,6,At-Risk
15391,1,289.87,583,1,1,1,3,At-Risk
15392,7,2911.62,4,4,4,4,12,High-Value
15393,5,891.34,15,4,3,3,10,High-Value
15394,11,5286.8,9,4,4,4,12,High-Value
15395,1,107.45,325,2,1,1,4,One-Time
15396,2,796.3800000000001,112,2,2,2,6,Other
15397,1,94.0,289,2,1,1,4,One-Time
15398,2,1345.53,15,4,2,3,9,High-Value
15399,3,815.77,0,4,2,2,8,Other
15400,8,1302.3,91,3,4,3,10,High-Value
15401,2,216.95000000000002,451,1,2,1,4,At-Risk
15402,6,1830.1200000000001,148,2,3,3,8,Other
15403,2,170.88,491,1,2,1,4,At-Risk
15404,1,257.06,375,2,1,1,4,One-Time
15405,2,659.84,188,2,2,2,6,Other
15406,4,975.87,30,3,3,3,9,High-Value
15407,4,1046.74,33,3,3,3,9,High-Value
15408,1,267.18,263,2,1,1,4,One-Time
15409,1,131.25,720,1,1,1,3,At-Risk
15410,10,4685.72,83,3,4,4,11,High-Value
15411,4,1348.93,25,3,3,3,9,High-Value
15412,1,190.53,170,2,1,1,4,One-Time
15413,5,6798.72,691,1,3,4,8,At-Risk
15414,3,774.9000000000001,9,4,2,2,8,Other
15415,1,559.61,312,2,1,2,5,Other
15416,7,4572.82,64,3,4,4,11,High-Value
15417,1,508.8,84,3,1,2,6,Other
15418,2,449.42,424,1,2,2,5,At-Risk
15419,1,135.85999999999999,24,4,1,1,6,One-Time
15420,6,743.0,433,1,3,2,6,At-Risk
15421,10,3805.34,58,3,4,4,11,High-Value
15422,7,1619.97,322,2,4,3,9,High-Value
15423,3,266.89,37,3,2,1,6,Other
15424,3,597.78,253,2,2,2,6,Other
15425,4,1941.1200000000001,399,1,3,3,7,At-Risk
15426,9,2156.35,18,4,4,3,11,High-Value
15427,3,1430.54,32,3,2,3,8,Other
15428,4,762.75,14,4,3,2,9,High-Value
15429,2,397.35,26,3,2,2,7,Other
15430,2,954.75,467,1,2,3,6,At-Risk
15431,1,153.24,502,1,1,1,3,At-Risk
15432,2,320.76,22,4,2,1,7,Other
15433,2,533.3,213,2,2,2,6,Other
15434,11,2567.06,7,4,4,4,12,High-Value
15435,1,149.29,21,4,1,1,6,One-Time
15436,3,1067.75,11,4,2,3,9,High-Value
15437,2,393.45,261,2,2,2,6,Other
15438,1,156.58,130,2,1,1,4,One-Time
15439,4,1269.05,404,1,3,3,7,At-Risk
15440,3,383.68,54,3,2,2,7,Other
15441,3,1254.21,395,1,2,3,6,At-Risk
15442,1,594.0,248,2,1,2,5,Other
15443,14,5114.2300000000005,1,4,4,4,12,High-Value
15444,2,1411.21,8,4,2,3,9,High-Value
15445,2,284.5,263,2,2,1,5,Other
15446,3,396.75,376,2,2,2,6,Other
15447,5,492.88,330,2,3,2,7,Other
15448,2,788.81,312,2,2,2,6,Other
15449,3,974.52,25,3,2,3,8,Other
15450,1,429.84,29,3,1,2,6,Other
15451,2,226.86,433,1,2,1,4,At-Risk
15452,6,1785.1100000000001,29,3,3,3,9,High-Value
15453,7,1371.77,1,4,4,3,11,High-Value
15454,2,303.89,361,2,2,1,5,Other
15455,1,38.25,597,1,1,1,3,At-Risk
15456,10,2091.52,282,2,4,3,9,High-Value
15457,1,237.07,261,2,1,1,4,One-Time
15458,2,370.44,24,4,2,2,8,Other
15459,2,202.83,416,1,2,1,4,At-Risk
15460,1,214.26,353,2,1,1,4,One-Time
15461,2,429.7,460,1,2,2,5,At-Risk
15462,4,737.05,93,3,3,2,8,Loyal
15463,1,126.14,28,3,1,1,5,One-Time
15464,1,1044.65,337,2,1,3,6,Other
15465,32,12100.4,19,4,4,4,12,High-Value
15466,4,1560.46,84,3,3,3,9,High-Value
15467,3,524.88,8,4,2,2,8,Other
15468,3,1430.48,50,3,2,3,8,Other
15469,3,874.25,49,3,2,3,8,Other
15470,1,63.42,575,1,1,1,3,At-Risk
15471,3,1292.01,1,4,2,3,9,High-Value
15472,1,371.56,112,2,1,2,5,Other
15473,8,2046.0,13,4,4,3,11,High-Value
15474,1,150.35,595,1,1,1,3,At-Risk
15475,1,454.11,76,3,1,2,6,Other
15476,4,2209.98,379,1,3,3,7,At-Risk
15477,1,368.4,649,1,1,2,4,At-Risk
15478,3,1940.98,39,3,2,3,8,Other
15479,1,147.4,732,1,1,1,3,At-Risk
15480,3,3592.25,115,2,2,4,8,Other
15481,1,1993.34,400,1,1,3,5,At-Risk
15482,18,14377.36,15,4,4,4,12,High-Value
15483,10,810.68,160,2,4,2,8,Other
15484,6,4652.1,0,4,3,4,11,High-Value
15485,7,4810.92,29,3,4,4,11,High-Value
15486,1,102.0,526,1,1,1,3,At-Risk
15487,1,231.32,679,1,1,1,3,At-Risk
15488,5,431.92,92,3,3,2,8,Loyal
15489,8,2419.61,22,4,4,4,12,High-Value
15490,1,210.85000000000002,429,1,1,1,3,At-Risk
15491,6,3100.09,94,3,3,4,10,High-Value
15492,2,659.46,27,3,2,2,7,Other
15493,9,4113.19,32,3,4,4,11,High-Value
15494,5,3702.6,20,4,3,4,11,High-Value
15495,1,246.5,378,2,1,1,4,One-Time
15496,1,146.14,630,1,1,1,3,At-Risk
15497,9,8657.39,17,4,4,4,12,High-Value
15498,44,24972.86,2,4,4,4,12,High-Value
15499,1,158.65,723,1,1,1,3,At-Risk
15500,4,1131.56,7,4,3,3,10,High-Value
15501,2,399.95,404,1,2,2,5,At-Risk
15502,12,9542.92,15,4,4,4,12,High-Value
15503,2,257.3,362,2,2,1,5,Other
15504,4,391.45,80,3,3,2,8,Loyal
15505,5,3610.96,52,3,3,4,10,High-Value
15506,6,2030.33,22,4,3,3,10,High-Value
15507,1,475.86,171,2,1,2,5,Other
15508,6,1000.27,188,2,3,3,8,Other
15509,1,152.41,379,1,1,1,3,At-Risk
15510,1,250.0,330,2,1,1,4,One-Time
15511,5,900.53,11,4,3,3,10,High-Value
15512,4,331.58,155,2,3,1,6,Other
15513,35,26437.05,32,3,4,4,11,High-Value
15514,18,6388.280000000001,11,4,4,4,12,High-Value
15515,1,171.81,386,1,1,1,3,At-Risk
15516,3,62.43,44,3,2,1,6,Other
15517,1,267.03,232,2,1,1,4,One-Time
15518,15,4189.99,63,3,4,4,11,High-Value
15519,2,344.61,382,1,2,2,5,At-Risk
15520,1,343.5,1,4,1,2,7,Other
15521,16,7087.64,39,3,4,4,11,High-Value
15522,2,397.99,32,3,2,2,7,Other
15523,16,17259.19,83,3,4,4,11,High-Value
15524,2,591.4,24,4,2,2,8,Other
15525,4,887.72,1,4,3,3,10,High-Value
15526,2,148.44,32,3,2,1,6,Other
15527,23,5554.04,18,4,4,4,12,High-Value
15528,1,229.33,253,2,1,1,4,One-Time
15529,12,4781.11,22,4,4,4,12,High-Value
15530,5,1808.68,21,4,3,3,10,High-Value
15531,2,1972.39,7,4,2,3,9,High-Value
15532,10,3717.2000000000003,24,4,4,4,12,High-Value
15533,3,807.5699999999999,18,4,2,2,8,Other
15534,1,162.25,725,1,1,1,3,At-Risk
15535,6,1044.3700000000001,172,2,3,3,8,Other
15536,1,259.09,408,1,1,1,3,At-Risk
15537,1,110.92,162,2,1,1,4,One-Time
15538,6,3358.4,537,1,3,4,8,At-Risk
15539,1,538.46,6,4,1,2,7,Other
15540,2,460.68,10,4,2,2,8,Other
15541,1,85.13000000000001,113,2,1,1,4,One-Time
15542,3,855.71,511,1,2,2,5,At-Risk
15543,2,242.26,287,2,2,1,5,Other
15544,20,7807.89,8,4,4,4,12,High-Value
15545,2,288.97,53,3,2,1,6,Other
15546,2,1079.1,606,1,2,3,6,At-Risk
15547,26,10002.65,6,4,4,4,12,High-Value
15548,1,158.09,595,1,1,1,3,At-Risk
15549,8,2330.41,76,3,4,4,11,High-Value
15550,12,2211.05,3,4,4,3,11,High-Value
15551,7,1679.81,36,3,4,3,10,High-Value
15552,2,252.52,216,2,2,1,5,Other
15553,1,428.93,59,3,1,2,6,Other
15554,1,217.2,277,2,1,1,4,One-Time
15555,36,11233.78,11,4,4,4,12,High-Value
15556,1,279.77,23,4,1,1,6,One-Time
15557,1,468.91,28,3,1,2,6,Other
15558,1,202.68,638,1,1,1,3,At-Risk
15559,1,1109.4,567,1,1,3,5,At-Risk
15560,2,153.52,397,1,2,1,4,At-Risk
15561,8,1934.3899999999999,11,4,4,3,11,High-Value
15562,3,671.4300000000001,351,2,2,2,6,Other
15563,6,2820.46,21,4,3,4,11,High-Value
15564,2,70.74000000000001,462,1,2,1,4,At-Risk
15565,2,173.16000000000003,49,3,2,1,6,Other
15566,2,227.87,392,1,2,1,4,At-Risk
15567,1,186.01,18,4,1,1,6,One-Time
15568,3,758.29,2,4,2,2,8,Other
15569,10,3583.4500000000003,103,2,4,4,10,High-Value
15570,25,8736.49,6,4,4,4,12,High-Value
15571,14,3892.35,11,4,4,4,12,High-Value
15572,10,3965.2,4,4,4,4,12,High-Value
15573,5,1180.47,31,3,3,3,9,High-Value
15574,6,1101.44,177,2,3,3,8,Other
15575,1,30.1,619,1,1,1,3,At-Risk
15576,1,921.37,37,3,1,3,7,Other
15577,5,396.03,150,2,3,2,7,Other
15578,1,127.10000000000001,161,2,1,1,4,One-Time
15579,5,1250.63,68,3,3,3,9,High-Value
15580,8,1375.39,376,2,4,3,9,High-Value
15581,34,4505.16,155,2,4,4,10,High-Value
15582,3,682.9100000000001,24,4,2,2,8,Other
15583,1,95.96,375,2,1,1,4,One-Time
15584,6,1268.2,23,4,3,3,10,High-Value
15585,1,455.3,176,2,1,2,5,Other
15586,3,1139.1,592,1,2,3,6,At-Risk
15587,7,1522.08,49,3,4,3,10,High-Value
15588,1,579.6,677,1,1,2,4,At-Risk
15589,3,478.53,255,2,2,2,6,Other
15590,5,1496.6,381,1,3,3,7,At-Risk
15591,3,217.9,582,1,2,1,4,At-Risk
15592,1,388.58,46,3,1,2,6,Other
15593,1,199.8,70,3,1,1,5,One-Time
15594,5,1771.78,15,4,3,3,10,High-Value
15595,1,357.59999999999997,487,1,1,2,4,At-Risk
15596,9,2727.72,100,2,4,4,10,High-Value
15597,2,563.37,34,3,2,2,7,Other
15598,2,548.02,52,3,2,2,7,Other
15599,3,1250.06,26,3,2,3,8,Other
15600,4,1199.31,427,1,3,3,7,At-Risk
15601,30,14191.74,10,4,4,4,12,High-Value
15602,16,3137.96,7,4,4,4,12,High-Value
15603,2,88.48,78,3,2,1,6,Other
15604,1,216.39000000000001,51,3,1,1,5,One-Time
15605,9,1741.95,35,3,4,3,10,High-Value
15606,17,5230.99,60,3,4,4,11,High-Value
15607,9,1708.97,336,2,4,3,9,High-Value
15608,5,1785.98,27,3,3,3,9,High-Value
15609,1,298.48,183,2,1,1,4,One-Time
15610,1,112.46000000000001,51,3,1,1,5,One-Time
15611,24,2976.28,9,4,4,4,12,High-Value
15612,2,195.15,35,3,2,1,6,Other
15613,1,433.71999999999997,609,1,1,2,4,At-Risk
15614,4,3147.36,437,1,3,4,8,At-Risk
15615,47,21373.97,9,4,4,4,12,High-Value
15616,1,317.11,437,1,1,1,3,At-Risk
15617,3,828.5500000000001,395,1,2,2,5,At-Risk
15618,4,776.851,32,3,3,2,8,Loyal
15619,1,336.4,10,4,1,1,6,One-Time
15620,4,1942.36,56,3,3,3,9,High-Value
15621,4,1293.03,3,4,3,3,10,High-Value
15622,17,7852.610000000001,42,3,4,4,11,High-Value
15623,8,2437.05,140,2,4,4,10,High-Value
15624,4,588.13,116,2,3,2,7,Other
15625,9,3236.4,103,2,4,4,10,High-Value
15626,3,1067.52,74,3,2,3,8,Other
15627,2,566.9,456,1,2,2,5,At-Risk
15628,17,5333.08,4,4,4,4,12,High-Value
15629,4,2240.9,449,1,3,3,7,At-Risk
15630,3,1481.4,44,3,2,3,8,Other
15631,1,596.67,641,1,1,2,4,At-Risk
15632,8,3285.31,15,4,4,4,12,High-Value
15633,13,4335.96,508,1,4,4,9,High-Value
15634,2,554.65,16,4,2,2,8,Other
15635,1,100.35,395,1,1,1,3,At-Risk
15636,4,1444.58,89,3,3,3,9,High-Value
15637,5,797.59,52,3,3,2,8,Loyal
15638,6,2265.2,378,2,3,4,9,High-Value
15639,3,1065.08,133,2,2,3,7,Other
15640,29,23459.51,3,4,4,4,12,High-Value
15641,12,5345.55,104,2,4,4,10,High-Value
15642,1,105.78,729,1,1,1,3,At-Risk
15643,3,664.0,191,2,2,2,6,Other
15644,4,803.54,165,2,3,2,7,Other
15645,3,1054.75,18,4,2,3,9,High-Value
15646,5,784.8100000000001,157,2,3,2,7,Other
15647,1,169.0,414,1,1,1,3,At-Risk
15648,2,639.5,203,2,2,2,6,Other
15649,4,1660.35,335,2,3,3,8,Other
15650,2,553.88,521,1,2,2,5,At-Risk
15651,5,1259.06,36,3,3,3,9,High-Value
15652,5,1405.94,90,3,3,3,9,High-Value
15653,2,877.44,92,3,2,3,8,Other
15654,2,922.53,8,4,2,3,9,High-Value
15655,1,560.6700000000001,242,2,1,2,5,Other
15656,4,748.5,44,3,3,2,8,Loyal
15657,1,30.0,22,4,1,1,6,One-Time
15658,8,2117.27,189,2,4,3,9,High-Value
15659,3,532.49,43,3,2,2,7,Other
15660,15,2603.69,24,4,4,4,12,High-Value
15661,8,1215.95,316,2,4,3,9,High-Value
15662,2,283.73,660,1,2,1,4,At-Risk
15663,1,138.14,105,2,1,1,4,One-Time
15664,4,1231.53,50,3,3,3,9,High-Value
15665,5,3987.07,167,2,3,4,9,High-Value
15666,2,632.94,471,1,2,2,5,At-Risk
15667,1,301.32000000000005,39,3,1,1,5,One-Time
15668,1,76.32000000000001,217,2,1,1,4,One-Time
15669,4,684.34,39,3,3,2,8,Loyal
15670,2,325.2,296,2,2,1,5,Other
15671,7,2657.13,18,4,4,4,12,High-Value
15672,1,45.300000000000004,724,1,1,1,3,At-Risk
15673,9,6204.32,87,3,4,4,11,High-Value
15674,12,6613.52,72,3,4,4,11,High-Value
15675,4,542.04,80,3,3,2,8,Loyal
15676,3,3435.76,18,4,2,4,10,High-Value
15677,3,1305.63,48,3,2,3,8,Other
15678,3,1825.94,52,3,2,3,8,Other
15679,4,781.28,23,4,3,2,9,High-Value
15680,10,4028.69,8,4,4,4,12,High-Value
15681,14,2989.7,24,4,4,4,12,High-Value
15682,2,318.24,598,1,2,1,4,At-Risk
15683,2,524.54,116,2,2,2,6,Other
15684,3,173.95,546,1,2,1,4,At-Risk
15685,1,55.980000000000004,449,1,1,1,3,At-Risk
15686,1,90.0,419,1,1,1,3,At-Risk
15687,9,2993.1,8,4,4,4,12,High-Value
15688,1,190.57,418,1,1,1,3,At-Risk
15689,3,521.03,119,2,3,2,7,Other
15690,2,239.76,3,4,2,1,7,Other
15691,4,571.3,251,2,3,2,7,Other
15692,1,191.04,27,3,1,1,5,One-Time
15693,1,37.5,658,1,1,1,3,At-Risk
15694,23,9963.48,0,4,4,4,12,High-Value
15695,4,1131.04,266,2,3,3,8,Other
15696,13,3881.2200000000003,32,3,4,4,11,High-Value
15697,1,246.75,689,1,1,1,3,At-Risk
15698,1,46.2,623,1,1,1,3,At-Risk
15699,1,309.65,17,4,1,1,6,One-Time
15700,2,696.68,171,2,2,2,6,Other
15701,4,1529.0,1,4,3,3,10,High-Value
15702,1,112.57,475,1,1,1,3,At-Risk
15703,1,211.5,264,2,1,1,4,One-Time
15704,6,3734.6600000000003,139,2,3,4,9,High-Value
15705,1,143.1,200,2,1,1,4,One-Time
15706,4,1060.56,63,3,3,3,9,High-Value
15707,4,916.98,34,3,3,3,9,High-Value
15708,9,3887.15,40,3,4,4,11,High-Value
15709,2,327.85,283,2,2,1,5,Other
15710,1,898.87,416,1,1,3,5,At-Risk
15711,2,420.25,556,1,2,2,5,At-Risk
15712,12,3472.41,8,4,4,4,12,High-Value
15713,4,839.64,142,2,3,2,7,Other
15714,5,783.96,11,4,3,2,9,High-Value
15715,5,658.02,555,1,3,2,6,At-Risk
15716,11,2482.7400000000002,145,2,4,4,10,High-Value
15717,5,607.0,233,2,3,2,7,Other
15718,1,293.79,539,1,1,1,3,At-Risk
15719,31,10194.32,32,3,4,4,11,High-Value
15720,2,739.22,23,4,2,2,8,Other
15721,1,471.40000000000003,11,4,1,2,7,Other
15722,11,5234.0,35,3,4,4,11,High-Value
15723,4,930.7,364,2,3,3,8,Other
15724,3,310.85,200,2,3,1,6,Other
15725,1,415.25,14,4,1,2,7,Other
15726,1,321.91,389,1,1,1,3,At-Risk
15727,15,9371.71,16,4,4,4,12,High-Value
15728,2,544.6,379,1,2,2,5,At-Risk
15729,3,192.55,212,2,3,1,6,Other
15730,5,1726.58,65,3,3,3,9,High-Value
15731,1,125.3,553,1,1,1,3,At-Risk
15732,10,1543.97,211,2,4,3,9,High-Value
15733,1,162.3,282,2,1,1,4,One-Time
15734,4,2263.3,114,2,3,4,9,High-Value
15735,1,327.68,420,1,1,1,3,At-Risk
15736,2,1767.1200000000001,434,1,2,3,6,At-Risk
15737,8,1188.1200000000001,14,4,4,3,11,High-Value
15738,41,13043.32,18,4,4,4,12,High-Value
15739,1,449.12,65,3,1,2,6,Other
15740,1,154.88,48,3,1,1,5,One-Time
15741,2,208.62,457,1,2,1,4,At-Risk
15742,1,156.87,618,1,1,1,3,At-Risk
15743,4,775.96,15,4,3,2,9,High-Value
15744,1,34.8,77,3,1,1,5,One-Time
15745,4,1094.5900000000001,18,4,3,3,10,High-Value
15746,1,196.88,133,2,1,1,4,One-Time
15747,9,2499.81,12,4,4,4,12,High-Value
15748,3,609.81,39,3,3,2,8,Loyal
15749,3,44534.3,234,2,3,4,9,High-Value
15750,18,6452.991,2,4,4,4,12,High-Value
15751,11,1380.44,460,1,4,3,8,At-Risk
15752,9,3924.91,39,3,4,4,11,High-Value
15753,1,79.2,304,2,1,1,4,One-Time
15754,9,3037.61,50,3,4,4,11,High-Value
15755,17,5993.12,9,4,4,4,12,High-Value
15756,4,528.01,60,3,3,2,8,Loyal
15757,6,2940.36,65,3,3,4,10,High-Value
15758,1,205.25,24,4,1,1,6,One-Time
15759,7,830.9300000000001,217,2,4,2,8,Other
15761,1,143.05,442,1,1,1,3,At-Risk
15762,2,583.75,64,3,2,2,7,Other
15763,2,1086.92,31,3,2,3,8,Other
15764,8,4503.08,87,3,4,4,11,High-Value
15765,1,370.63,666,1,1,2,4,At-Risk
15766,3,831.0600000000001,63,3,3,2,8,Loyal
15768,34,15308.89,115,2,4,4,10,High-Value
15769,46,88612.52,6,4,4,4,12,High-Value
15770,1,321.45,612,1,1,1,3,At-Risk
15771,3,1006.54,603,1,3,3,7,At-Risk
15772,1,280.88,417,1,1,1,3,At-Risk
15773,2,774.52,5,4,2,2,8,Other
15774,6,1287.09,68,3,3,3,9,High-Value
15775,2,150.5,244,2,2,1,5,Other
15776,1,241.62,132,2,1,1,4,One-Time
15777,7,1762.6100000000001,240,2,4,3,9,High-Value
15778,1,307.95000000000005,430,1,1,1,3,At-Risk
15779,2,124.08000000000001,462,1,2,1,4,At-Risk
15780,3,475.28000000000003,183,2,3,2,7,Other
15781,3,345.46000000000004,24,4,3,2,9,High-Value
15782,4,4014.1,9,4,3,4,11,High-Value
15783,1,246.3,10,4,1,1,6,One-Time
15784,2,848.33,467,1,2,2,5,At-Risk
15785,16,5969.93,32,3,4,4,11,High-Value
15786,5,8501.62,45,3,3,4,10,High-Value
15787,3,933.26,25,3,3,3,9,High-Value
15788,1,221.82999999999998,508,1,1,1,3,At-Risk
15789,6,1962.01,357,2,3,3,8,Other
15790,1,218.75,9,4,1,1,6,One-Time
15791,5,3608.34,43,3,3,4,10,High-Value
15792,2,933.84,399,1,2,3,6,At-Risk
15793,8,2399.57,14,4,4,4,12,High-Value
15794,2,777.0,735,1,2,2,5,At-Risk
15795,8,1979.8700000000001,149,2,4,3,9,High-Value
15796,17,5170.63,0,4,4,4,12,High-Value
15797,5,2806.08,112,2,3,4,9,High-Value
15798,3,1535.37,492,1,3,3,7,At-Risk
15799,4,1421.34,75,3,3,3,9,High-Value
15800,7,1227.07,106,2,4,3,9,High-Value
15801,3,1063.95,45,3,3,3,9,High-Value
15803,4,1929.66,50,3,3,3,9,High-Value
15804,13,4206.39,0,4,4,4,12,High-Value
15805,30,10148.93,22,4,4,4,12,High-Value
15806,3,784.58,45,3,3,2,8,Loyal
15807,5,1817.52,49,3,3,3,9,High-Value
15808,21,17180.25,305,2,4,4,10,High-Value
15809,7,1274.44,35,3,4,3,10,High-Value
15810,8,2999.04,78,3,4,4,11,High-Value
15811,7,3392.55,21,4,4,4,12,High-Value
15812,12,5201.47,106,2,4,4,10,High-Value
15813,2,1303.91,207,2,2,3,7,Other
15814,6,2634.44,16,4,3,4,11,High-Value
15815,5,2100.6,63,3,3,3,9,High-Value
15816,2,144.15,541,1,2,1,4,At-Risk
15817,3,2766.4,420,1,3,4,8,At-Risk
15818,1,340.5,587,1,1,2,4,At-Risk
15819,10,3934.79,48,3,4,4,11,High-Value
15820,1,206.98,319,2,1,1,4,One-Time
15821,2,570.96,43,3,2,2,7,Other
15822,6,1840.06,2,4,3,3,10,High-Value
15823,2,3867.17,728,1,2,4,7,At-Risk
15824,2,890.94,452,1,2,3,6,At-Risk
15825,1,532.94,171,2,1,2,5,Other
15826,4,2598.28,55,3,3,4,10,High-Value
15827,28,3603.14,72,3,4,4,11,High-Value
15828,1,1108.82,374,2,1,3,6,Other
15829,2,636.14,98,2,2,2,6,Other
15830,1,576.0,37,3,1,2,6,Other
15831,3,794.64,57,3,3,2,8,Loyal
15832,1,836.79,253,2,1,2,5,Other
15833,1,80.4,737,1,1,1,3,At-Risk
15834,7,3761.89,69,3,4,4,11,High-Value
15835,4,954.09,43,3,3,3,9,High-Value
15836,1,137.37,49,3,1,1,5,One-Time
15837,2,777.01,64,3,2,2,7,Other
15838,34,73205.5,10,4,4,4,12,High-Value
15839,3,1048.49,32,3,3,3,9,High-Value
15840,2,355.56,58,3,2,2,7,Other
15841,9,2742.41,72,3,4,4,11,High-Value
15842,2,548.8000000000001,392,1,2,2,5,At-Risk
15843,1,118.95,303,2,1,1,4,One-Time
15844,1,130.74,45,3,1,1,5,One-Time
15845,11,4426.28,17,4,4,4,12,High-Value
15846,1,107.01,384,1,1,1,3,At-Risk
15847,5,822.57,37,3,3,2,8,Loyal
15848,1,137.99,621,1,1,1,3,At-Risk
15850,6,1006.75,18,4,3,3,10,High-Value
15851,1,109.73,526,1,1,1,3,At-Risk
15852,3,257.26,186,2,3,1,6,Other
15853,1,110.8,51,3,1,1,5,One-Time
15854,21,5578.28,3,4,4,4,12,High-Value
15855,6,1052.72,136,2,3,3,8,Other
15856,52,32274.69,3,4,4,4,12,High-Value
15857,2,570.48,18,4,2,2,8,Other
15858,13,3552.41,15,4,4,4,12,High-Value
15859,1,438.46000000000004,431,1,1,2,4,At-Risk
15860,17,2358.8,40,3,4,4,11,High-Value
15861,12,4360.9,11,4,4,4,12,High-Value
15862,13,2507.14,7,4,4,4,12,High-Value
15863,5,355.1,25,3,3,2,8,Loyal
15864,7,2180.76,21,4,4,3,11,High-Value
15865,5,2241.42,40,3,3,4,10,High-Value
15866,1,211.89,100,2,1,1,4,One-Time
15867,31,8869.87,4,4,4,4,12,High-Value
15868,1,94.53,582,1,1,1,3,At-Risk
15869,3,321.11,276,2,3,1,6,Other
15870,4,857.46,32,3,3,3,9,High-Value
15871,1,33.1,436,1,1,1,3,At-Risk
15872,4,729.25,14,4,3,2,9,High-Value
15873,4,313.91999999999996,499,1,3,1,5,At-Risk
15874,21,11284.76,63,3,4,4,11,High-Value
15875,1,108.52,645,1,1,1,3,At-Risk
15876,2,1449.14,408,1,2,3,6,At-Risk
15877,2,490.33,1,4,2,2,8,Other
15878,2,330.77,561,1,2,1,4,At-Risk
15879,4,1137.8,403,1,3,3,7,At-Risk
15880,1,329.03,368,2,1,1,4,One-Time
15881,5,501.39,311,2,3,2,7,Other
15882,8,1122.38,198,2,4,3,9,High-Value
15883,2,396.48,1,4,2,2,8,Other
15884,2,244.60000000000002,431,1,2,1,4,At-Risk
15885,13,1921.82,92,3,4,3,10,High-Value
15886,4,1052.8700000000001,59,3,3,3,9,High-Value
15887,3,1027.15,406,1,3,3,7,At-Risk
15888,3,423.49,80,3,3,2,8,Loyal
15889,8,1407.05,156,2,4,3,9,High-Value
15890,5,535.65,394,1,3,2,6,At-Risk
15891,1,509.13,226,2,1,2,5,Other
15892,1,128.2,668,1,1,1,3,At-Risk
15893,1,305.28000000000003,481,1,1,1,3,At-Risk
15894,2,257.6,252,2,2,1,5,Other
15895,1,179.17,149,2,1,1,4,One-Time
15897,2,208.59,193,2,2,1,5,Other
15898,25,4992.7,0,4,4,4,12,High-Value
15899,1,56.25,368,2,1,1,4,One-Time
15900,4,886.57,23,4,3,3,10,High-Value
15901,6,667.89,16,4,3,2,9,High-Value
15902,1,145.01,379,1,1,1,3,At-Risk
15903,12,8939.84,9,4,4,4,12,High-Value
15904,1,164.68,7,4,1,1,6,One-Time
15905,1,114.69,542,1,1,1,3,At-Risk
15906,10,2530.19,19,4,4,4,12,High-Value
15907,3,881.87,3,4,3,3,10,High-Value
15908,2,758.62,490,1,2,2,5,At-Risk
15909,1,191.94,173,2,1,1,4,One-Time
15910,15,2661.17,0,4,4,4,12,High-Value
15911,8,1683.79,623,1,4,3,8,At-Risk
15912,9,1074.7,177,2,4,3,9,High-Value
15913,1,6.300000000000001,533,1,1,1,3,At-Risk
15914,2,205.99,377,2,2,1,5,Other
15915,1,364.24,401,1,1,2,4,At-Risk
15916,13,3145.24,15,4,4,4,12,High-Value
15917,5,530.17,247,2,3,2,7,Other
15918,3,582.88,190,2,3,2,7,Other
15919,2,525.69,19,4,2,2,8,Other
15920,8,565.19,153,2,4,2,8,Other
15921,4,765.61,172,2,3,2,7,Other
15922,1,369.5,372,2,1,2,5,Other
15923,1,127.08,372,2,1,1,4,One-Time
15924,1,102.82,730,1,1,1,3,At-Risk
15925,1,207.15,193,2,1,1,4,One-Time
15926,1,134.44,541,1,1,1,3,At-Risk
15927,1,106.54,646,1,1,1,3,At-Risk
15928,1,293.53000000000003,655,1,1,1,3,At-Risk
15929,1,594.0,643,1,1,2,4,At-Risk
15930,1,426.63,66,3,1,2,6,Other
15931,1,239.9,427,1,1,1,3,At-Risk
15932,8,2495.87,3,4,4,4,12,High-Value
15933,3,1107.46,20,4,3,3,10,High-Value
15934,2,2190.66,417,1,2,3,6,At-Risk
15935,1,108.03999999999999,238,2,1,1,4,One-Time
15936,2,282.79,378,2,2,1,5,Other
15937,1,145.35,63,3,1,1,5,One-Time
15938,9,734.8100000000001,111,2,4,2,8,Other
15939,15,9004.84,89,3,4,4,11,High-Value
15940,1,35.8,310,2,1,1,4,One-Time
15941,1,405.0,636,1,1,2,4,At-Risk
15942,1,337.44,133,2,1,1,4,One-Time
15943,2,271.29,649,1,2,1,4,At-Risk
15944,4,2164.24,276,2,3,3,8,Other
15945,4,646.27,364,2,3,2,7,Other
15946,3,2304.1800000000003,502,1,3,4,8,At-Risk
15947,1,1708.24,82,3,1,3,7,Other
15948,3,1509.0900000000001,7,4,3,3,10,High-Value
15949,2,364.72,16,4,2,2,8,Other
15950,10,7120.91,31,3,4,4,11,High-Value
15951,3,1013.1700000000001,8,4,3,3,10,High-Value
15952,4,781.91,33,3,3,2,8,Loyal
15953,18,3440.34,14,4,4,4,12,High-Value
15954,1,187.8,588,1,1,1,3,At-Risk
15955,22,8085.9800000000005,23,4,4,4,12,High-Value
15956,2,617.6,550,1,2,2,5,At-Risk
15957,3,921.25,31,3,3,3,9,High-Value
15958,4,462.12,73,3,3,2,8,Loyal
15959,3,542.89,681,1,3,2,6,At-Risk
15960,4,410.95,373,2,3,2,7,Other
15961,1,451.28999999999996,378,2,1,2,5,Other
15962,1,289.48,448,1,1,1,3,At-Risk
15963,2,470.76,19,4,2,2,8,Other
15964,1,269.21,662,1,1,1,3,At-Risk
15965,13,2771.94,16,4,4,4,12,High-Value
15966,1,426.53,450,1,1,2,4,At-Risk
15967,12,2966.0,22,4,4,4,12,High-Value
15968,1,401.8,387,1,1,2,4,At-Risk
15969,5,1127.05,2,4,3,3,10,High-Value
15970,2,1017.3199999999999,303,2,2,3,7,Other
15971,18,5897.88,17,4,4,4,12,High-Value
15972,5,1769.33,455,1,3,3,7,At-Risk
15973,2,665.62,366,2,2,2,6,Other
15974,7,3442.15,38,3,4,4,11,High-Value
15975,1,371.01,83,3,1,2,6,Other
15976,6,1680.31,164,2,3,3,8,Other
15977,2,1054.73,16,4,2,3,9,High-Value
15978,3,3279.42,76,3,3,4,10,High-Value
15979,1,329.21999999999997,602,1,1,1,3,At-Risk
15980,7,6543.68,88,3,4,4,11,High-Value
15981,21,9362.77,24,4,4,4,12,High-Value
15982,1,324.51,604,1,1,1,3,At-Risk
15983,8,3110.37,21,4,4,4,12,High-Value
15984,30,8393.02,2,4,4,4,12,High-Value
15985,7,2715.28,122,2,4,4,10,High-Value
15986,2,354.42,29,3,2,2,7,Other
15987,8,1535.99,11,4,4,3,11,High-Value
15988,3,736.39,18,4,3,2,9,High-Value
15989,2,368.31,375,2,2,2,6,Other
15990,7,1997.75,43,3,4,3,10,High-Value
15991,1,150.55,533,1,1,1,3,At-Risk
15992,3,896.6,3,4,3,3,10,High-Value
15993,7,2768.97,8,4,4,4,12,High-Value
15994,3,1175.68,54,3,3,3,9,High-Value
15995,1,694.54,413,1,1,2,4,At-Risk
15996,7,1386.4,87,3,4,3,10,High-Value
15998,16,8274.14,36,3,4,4,11,High-Value
15999,1,20.4,735,1,1,1,3,At-Risk
16000,3,12393.7,2,4,3,4,11,High-Value
16001,1,583.39,380,1,1,2,4,At-Risk
16002,1,169.21,624,1,1,1,3,At-Risk
16003,10,5613.83,29,3,4,4,11,High-Value
16004,5,2146.39,474,1,3,3,7,At-Risk
16005,10,2365.07,11,4,4,4,12,High-Value
16006,2,332.82,210,2,2,1,5,Other
16007,7,3053.06,47,3,4,4,11,High-Value
16008,15,5339.13,23,4,4,4,12,High-Value
16009,4,972.11,21,4,3,3,10,High-Value
16010,11,1694.86,245,2,4,3,9,High-Value
16011,29,5599.31,7,4,4,4,12,High-Value
16012,5,2978.59,34,3,3,4,10,High-Value
16013,84,56078.44,3,4,4,4,12,High-Value
16014,5,1100.28,37,3,3,3,9,High-Value
16015,3,704.26,3,4,3,2,9,High-Value
16016,11,2083.4,2,4,4,3,11,High-Value
16017,5,1545.58,46,3,3,3,9,High-Value
16018,4,698.13,38,3,3,2,8,Loyal
16019,27,17329.16,46,3,4,4,11,High-Value
16020,3,851.01,16,4,3,2,9,High-Value
16021,2,487.03,394,1,2,2,5,At-Risk
16022,1,602.63,259,2,1,2,5,Other
16023,3,719.81,45,3,3,2,8,Loyal
16024,3,478.71,11,4,3,2,9,High-Value
16025,1,439.65999999999997,29,3,1,2,6,Other
16026,1,236.09,42,3,1,1,5,One-Time
16027,15,2048.36,91,3,4,3,10,High-Value
16028,1,82.2,595,1,1,1,3,At-Risk
16029,106,109620.87,38,3,4,4,11,High-Value
16030,1,331.24,309,2,1,1,4,One-Time
16031,2,547.9,91,3,2,2,7,Other
16032,6,1965.72,455,1,3,3,7,At-Risk
16033,27,10608.81,5,4,4,4,12,High-Value
16034,6,911.32,195,2,3,3,8,Other
16035,1,217.73,559,1,1,1,3,At-Risk
16036,4,2556.84,86,3,3,4,10,High-Value
16037,5,1509.3400000000001,269,2,3,3,8,Other
16038,3,471.78,7,4,3,2,9,High-Value
16039,2,456.4,423,1,2,2,5,At-Risk
16040,7,2416.9,64,3,4,4,11,High-Value
16041,3,3166.4,30,3,3,4,10,High-Value
16042,8,2245.32,21,4,4,4,12,High-Value
16043,8,1856.5900000000001,37,3,4,3,10,High-Value
16044,1,340.84,434,1,1,2,4,At-Risk
16045,8,3434.93,119,2,4,4,10,High-Value
16046,1,235.78,561,1,1,1,3,At-Risk
16048,4,818.7900000000001,372,2,3,2,7,Other
16049,6,1852.15,39,3,3,3,9,High-Value
16050,3,300.7,173,2,3,1,6,Other
16051,1,188.44,681,1,1,1,3,At-Risk
16052,1,362.06,53,3,1,2,6,Other
16053,6,3634.84,32,3,3,4,10,High-Value
16054,4,2111.88,144,2,3,3,8,Other
16055,1,134.8,220,2,1,1,4,One-Time
16056,1,650.75,44,3,1,2,6,Other
16057,10,3854.85,15,4,4,4,12,High-Value
16058,1,62.7,405,1,1,1,3,At-Risk
16059,12,3053.57,65,3,4,4,11,High-Value
16060,3,541.95,400,1,3,2,6,At-Risk
16061,1,89.65,430,1,1,1,3,At-Risk
16062,8,2863.45,9,4,4,4,12,High-Value
16063,1,335.32,259,2,1,1,4,One-Time
16064,1,109.31,724,1,1,1,3,At-Risk
16065,8,1992.13,364,2,4,3,9,High-Value
16066,5,1521.04,16,4,3,3,10,High-Value
16067,3,3269.11,562,1,3,4,8,At-Risk
16068,1,115.73,593,1,1,1,3,At-Risk
16069,1,457.7,417,1,1,2,4,At-Risk
16070,2,852.15,21,4,2,2,8,Other
16071,4,1076.8,44,3,3,3,9,High-Value
16072,4,4180.09,287,2,3,4,9,High-Value
16073,1,122.4,296,2,1,1,4,One-Time
16074,1,252.5,389,1,1,1,3,At-Risk
16075,2,736.9300000000001,502,1,2,2,5,At-Risk
16076,10,2234.73,2,4,4,3,11,High-Value
16077,1,2300.3999999999996,625,1,1,4,6,At-Risk
16078,2,362.99,283,2,2,2,6,Other
16079,3,1352.0,16,4,3,3,10,High-Value
16080,4,602.5600000000001,81,3,3,2,8,Loyal
16081,8,4278.96,55,3,4,4,11,High-Value
16082,1,106.75,669,1,1,1,3,At-Risk
16083,4,2351.42,100,2,3,4,9,High-Value
16084,1,436.18,298,2,1,2,5,Other
16085,12,2324.71,22,4,4,4,12,High-Value
16086,10,2687.73,58,3,4,4,11,High-Value
16087,5,1739.92,388,1,3,3,7,At-Risk
16088,2,1437.43,575,1,2,3,6,At-Risk
16089,2,263.49,385,1,2,1,4,At-Risk
16090,1,180.56,623,1,1,1,3,At-Risk
16091,2,315.06,154,2,2,1,5,Other
16092,6,1587.94,114,2,3,3,8,Other
16093,1,17.0,106,2,1,1,4,One-Time
16094,11,3695.56,11,4,4,4,12,High-Value
16095,1,447.05,455,1,1,2,4,At-Risk
16096,4,1584.97,263,2,3,3,8,Other
16097,1,185.04999999999998,239,2,1,1,4,One-Time
16098,14,4010.7,87,3,4,4,11,High-Value
16099,7,1573.2,49,3,4,3,10,High-Value
16100,1,582.64,462,1,1,2,4,At-Risk
16101,4,3229.16,70,3,3,4,10,High-Value
16102,3,1842.14,41,3,3,3,9,High-Value
16103,22,6191.71,6,4,4,4,12,High-Value
16104,9,2774.46,61,3,4,4,11,High-Value
16105,5,2386.19,248,2,3,4,9,High-Value
16106,1,108.38,65,3,1,1,5,One-Time
16107,7,3204.1600000000003,17,4,4,4,12,High-Value
16108,4,2235.92,84,3,3,3,9,High-Value
16109,3,939.48,218,2,3,3,8,Other
16110,4,1781.59,44,3,3,3,9,High-Value
16111,1,549.33,427,1,1,2,4,At-Risk
16112,4,195.74,142,2,3,1,6,Other
16113,1,161.38,182,2,1,1,4,One-Time
16114,1,135.75,170,2,1,1,4,One-Time
16115,12,2553.8,9,4,4,4,12,High-Value
16116,1,612.78,211,2,1,2,5,Other
16117,3,654.4,189,2,3,2,7,Other
16118,1,4376.25,652,1,1,4,6,At-Risk
16119,8,1720.81,7,4,4,3,11,High-Value
16120,6,2967.5099999999998,58,3,3,4,10,High-Value
16121,5,1450.04,56,3,3,3,9,High-Value
16122,6,895.62,72,3,3,3,9,High-Value
16123,1,307.78000000000003,51,3,1,1,5,One-Time
16124,4,1772.49,316,2,3,3,8,Other
16125,14,4292.35,366,2,4,4,10,High-Value
16126,15,14644.6,28,3,4,4,11,High-Value
16127,2,801.3100000000001,38,3,2,2,7,Other
16128,11,3801.05,17,4,4,4,12,High-Value
16129,3,1396.05,406,1,3,3,7,At-Risk
16130,4,987.48,421,1,3,3,7,At-Risk
16131,12,9957.42,51,3,4,4,11,High-Value
16132,2,664.2,543,1,2,2,5,At-Risk
16133,56,22992.26,3,4,4,4,12,High-Value
16134,5,2145.34,21,4,3,3,10,High-Value
16135,2,819.45,262,2,2,2,6,Other
16136,4,946.8000000000001,59,3,3,3,9,High-Value
16137,1,422.7,679,1,1,2,4,At-Risk
16138,3,910.35,378,2,3,3,8,Other
16139,5,1111.15,18,4,3,3,10,High-Value
16140,3,1433.46,65,3,3,3,9,High-Value
16141,2,955.94,87,3,2,3,8,Other
16142,1,535.34,249,2,1,2,5,Other
16143,12,4555.08,2,4,4,4,12,High-Value
16144,1,175.2,246,2,1,1,4,One-Time
16145,19,6805.4400000000005,8,4,4,4,12,High-Value
16146,4,946.38,156,2,3,3,8,Other
16147,5,2398.91,133,2,3,4,9,High-Value
16148,2,386.62,295,2,2,2,6,Other
16149,3,422.21999999999997,4,4,3,2,9,High-Value
16150,10,4002.17,42,3,4,4,11,High-Value
16152,1,1829.04,268,2,1,3,6,Other
16153,11,5133.49,49,3,4,4,11,High-Value
16155,5,796.9,381,1,3,2,6,At-Risk
16156,20,6188.18,8,4,4,4,12,High-Value
16157,3,656.69,15,4,3,2,9,High-Value
16158,9,628.32,521,1,4,2,7,At-Risk
16159,4,1232.79,281,2,3,3,8,Other
16160,2,1025.44,64,3,2,3,8,Other
16161,43,12580.06,1,4,4,4,12,High-Value
16162,1,37.4,251,2,1,1,4,One-Time
16163,6,2407.98,231,2,3,4,9,High-Value
16164,3,822.48,16,4,3,2,9,High-Value
16165,1,79.9,504,1,1,1,3,At-Risk
16166,2,435.83000000000004,427,1,2,2,5,At-Risk
16167,5,1386.12,413,1,3,3,7,At-Risk
16168,66,10360.67,10,4,4,4,12,High-Value
16169,4,1822.97,7,4,3,3,10,High-Value
16170,20,6869.0,50,3,4,4,11,High-Value
16171,1,73.19999999999999,58,3,1,1,5,One-Time
16172,8,1884.55,94,3,4,3,10,High-Value
16173,6,1418.32,15,4,3,3,10,High-Value
16174,7,2246.75,125,2,4,4,10,High-Value
16175,7,1836.44,93,3,4,3,10,High-Value
16176,4,2052.69,420,1,3,3,7,At-Risk
16177,8,2247.31,49,3,4,4,11,High-Value
16178,2,612.6,137,2,2,2,6,Other
16179,1,215.83,60,3,1,1,5,One-Time
16180,13,16249.87,99,2,4,4,10,High-Value
16181,1,305.54,72,3,1,1,5,One-Time
16182,9,9971.65,71,3,4,4,11,High-Value
16183,4,1077.81,66,3,3,3,9,High-Value
16184,6,1158.79,63,3,3,3,9,High-Value
16185,3,644.72,16,4,3,2,9,High-Value
16186,26,8718.43,22,4,4,4,12,High-Value
16187,15,6911.4400000000005,31,3,4,4,11,High-Value
16188,5,1087.66,44,3,3,3,9,High-Value
16189,2,215.48,15,4,2,1,7,Other
16190,8,2723.55,39,3,4,4,11,High-Value
16191,24,15677.820000000002,2,4,4,4,12,High-Value
16192,1,351.3,735,1,1,2,4,At-Risk
16193,2,630.4300000000001,236,2,2,2,6,Other
16194,1,308.6,374,2,1,1,4,One-Time
16195,1,323.25,722,1,1,1,3,At-Risk
16196,1,93.3,488,1,1,1,3,At-Risk
16197,9,2016.71,468,1,4,3,8,At-Risk
16198,2,1030.0410000000002,74,3,2,3,8,Other
16199,7,942.75,391,1,4,3,8,At-Risk
16200,12,5608.1,3,4,4,4,12,High-Value
16201,5,2112.12,2,4,3,3,10,High-Value
16202,9,2501.9900000000002,360,2,4,4,10,High-Value
16203,6,943.84,58,3,3,3,9,High-Value
16204,3,918.71,22,4,3,3,10,High-Value
16205,7,1813.51,30,3,4,3,10,High-Value
16206,13,2577.12,54,3,4,4,11,High-Value
16207,1,394.38,24,4,1,2,7,Other
16208,10,3440.4500000000003,44,3,4,4,11,High-Value
16209,9,4146.78,88,3,4,4,11,High-Value
16210,33,33730.97,1,4,4,4,12,High-Value
16211,3,1090.59,88,3,3,3,9,High-Value
16212,4,1293.71,18,4,3,3,10,High-Value
16213,1,159.0,78,3,1,1,5,One-Time
16214,4,2038.25,170,2,3,3,8,Other
16215,1,242.35,80,3,1,1,5,One-Time
16216,1,914.9300000000001,266,2,1,3,6,Other
16217,2,304.25,234,2,2,1,5,Other
16218,13,3968.67,29,3,4,4,11,High-Value
16219,1,40.8,500,1,1,1,3,At-Risk
16221,9,2018.47,36,3,4,3,10,High-Value
16222,2,1272.05,317,2,2,3,7,Other
16223,2,1087.05,374,2,2,3,7,Other
16224,5,1616.54,56,3,3,3,9,High-Value
16225,15,2859.31,44,3,4,4,11,High-Value
16226,5,672.17,202,2,3,2,7,Other
16227,3,1027.22,224,2,3,3,8,Other
16228,3,885.71,384,1,3,3,7,At-Risk
16229,6,2867.86,86,3,3,4,10,High-Value
16230,2,542.03,189,2,2,2,6,Other
16231,4,1074.47,378,2,3,3,8,Other
16232,7,2712.97,43,3,4,4,11,High-Value
16233,9,1818.31,70,3,4,3,10,High-Value
16234,3,333.18,475,1,3,1,5,At-Risk
16235,8,2043.71,40,3,4,3,10,High-Value
16236,1,432.2,77,3,1,2,6,Other
16237,1,136.65,436,1,1,1,3,At-Risk
16238,1,63.66,422,1,1,1,3,At-Risk
16239,6,1492.2,56,3,3,3,9,High-Value
16240,2,3718.8,23,4,2,4,10,High-Value
16241,16,3989.81,9,4,4,4,12,High-Value
16242,14,7404.650000000001,7,4,4,4,12,High-Value
16243,2,409.1,33,3,2,2,7,Other
16244,2,1522.75,211,2,2,3,7,Other
16245,3,1413.66,23,4,3,3,10,High-Value
16246,2,821.35,459,1,2,2,5,At-Risk
16247,1,114.56,169,2,1,1,4,One-Time
16248,1,152.94,61,3,1,1,5,One-Time
16249,5,1800.07,52,3,3,3,9,High-Value
16250,3,565.24,260,2,3,2,7,Other
16251,1,128.31,511,1,1,1,3,At-Risk
16252,1,295.09000000000003,382,1,1,1,3,At-Risk
16253,7,7222.2,66,3,4,4,11,High-Value
16254,3,967.44,377,2,3,3,8,Other
16255,15,4530.0,16,4,4,4,12,High-Value
16256,3,1579.37,266,2,3,3,8,Other
16257,1,21.95,176,2,1,1,4,One-Time
16258,15,11942.52,44,3,4,4,11,High-Value
16259,3,340.94,409,1,3,2,6,At-Risk
16260,1,1035.45,50,3,1,3,7,Other
16261,6,1041.16,16,4,3,3,10,High-Value
16262,1,755.15,377,2,1,2,5,Other
16263,1,348.16,422,1,1,2,4,At-Risk
16264,2,823.53,437,1,2,2,5,At-Risk
16265,12,6685.17,8,4,4,4,12,High-Value
16266,14,1757.95,73,3,4,3,10,High-Value
16267,1,186.66,590,1,1,1,3,At-Risk
16268,2,617.65,70,3,2,2,7,Other
16269,1,717.57,437,1,1,2,4,At-Risk
16270,1,1141.24,352,2,1,3,6,Other
16271,8,3367.82,15,4,4,4,12,High-Value
16272,1,411.7,116,2,1,2,5,Other
16273,2,318.34000000000003,647,1,2,1,4,At-Risk
16274,1,331.55,372,2,1,1,4,One-Time
16275,3,2151.11,196,2,3,3,8,Other
16276,3,2629.3900000000003,176,2,3,4,9,High-Value
16277,1,188.69,733,1,1,1,3,At-Risk
16278,3,1117.84,99,2,3,3,8,Other
16279,9,5698.28,20,4,4,4,12,High-Value
16280,1,238.05,724,1,1,1,3,At-Risk
16281,3,3424.02,71,3,3,4,10,High-Value
16282,3,1307.58,339,2,3,3,8,Other
16283,8,4348.62,5,4,4,4,12,High-Value
16284,3,1018.48,30,3,3,3,9,High-Value
16285,1,176.9,645,1,1,1,3,At-Risk
16286,2,328.95,476,1,2,1,4,At-Risk
16287,5,1006.98,169,2,3,3,8,Other
16288,1,129.85,469,1,1,1,3,At-Risk
16289,1,136.31,461,1,1,1,3,At-Risk
16290,4,1957.7,464,1,3,3,7,At-Risk
16292,5,1253.76,121,2,3,3,8,Other
16293,15,4279.2,21,4,4,4,12,High-Value
16294,1,126.05000000000001,476,1,1,1,3,At-Risk
16295,4,1328.55,9,4,3,3,10,High-Value
16296,4,1313.67,625,1,3,3,7,At-Risk
16297,1,301.9,268,2,1,1,4,One-Time
16298,7,1085.7,22,4,4,3,11,High-Value
16299,1,193.65,476,1,1,1,3,At-Risk
16300,3,1367.32,429,1,3,3,7,At-Risk
16301,1,107.33,736,1,1,1,3,At-Risk
16302,1,233.22,126,2,1,1,4,One-Time
16303,7,7928.27,25,3,4,4,11,High-Value
16304,1,381.66,694,1,1,2,4,At-Risk
16305,1,361.22,138,2,1,2,5,Other
16306,7,1124.72,213,2,4,3,9,High-Value
16307,3,1194.92,428,1,3,3,7,At-Risk
16308,7,5120.0,37,3,4,4,11,High-Value
16309,2,706.57,105,2,2,2,6,Other
16310,2,460.08,413,1,2,2,5,At-Risk
16311,2,616.26,17,4,2,2,8,Other
16312,1,171.15,431,1,1,1,3,At-Risk
16313,2,274.15,2,4,2,1,7,Other
16314,3,1491.4,389,1,3,3,7,At-Risk
16315,2,402.71,330,2,2,2,6,Other
16316,13,5744.91,63,3,4,4,11,High-Value
16317,5,2192.51,119,2,3,3,8,Other
16318,1,328.15000000000003,34,3,1,1,5,One-Time
16319,1,404.40000000000003,217,2,1,2,5,Other
16320,6,5628.99,171,2,3,4,9,High-Value
16321,7,604.5500000000001,71,3,4,2,9,High-Value
16322,2,326.75,0,4,2,1,7,Other
16323,2,353.66,195,2,2,2,6,Other
16324,3,408.59,127,2,3,2,7,Other
16325,12,3597.5,46,3,4,4,11,High-Value
16326,24,4626.25,5,4,4,4,12,High-Value
16327,16,10129.04,13,4,4,4,12,High-Value
16328,1,310.83000000000004,562,1,1,1,3,At-Risk
16329,4,1664.92,427,1,3,3,7,At-Risk
16330,7,625.38,17,4,4,2,10,High-Value
16331,6,2037.7,431,1,3,3,7,At-Risk
16332,11,1997.49,27,3,4,3,10,High-Value
16333,22,26626.8,7,4,4,4,12,High-Value
16334,1,263.73,491,1,1,1,3,At-Risk
16335,7,2753.52,551,1,4,4,9,High-Value
16336,4,3517.69,420,1,3,4,8,At-Risk
16337,1,151.05,36,3,1,1,5,One-Time
16338,1,214.8,156,2,1,1,4,One-Time
16339,1,94.05,283,2,1,1,4,One-Time
16340,3,1496.24,106,2,3,3,8,Other
16341,7,3850.79,24,4,4,4,12,High-Value
16342,4,322.41,74,3,3,1,7,Loyal
16343,3,614.12,15,4,3,2,9,High-Value
16344,4,842.42,157,2,3,2,7,Other
16345,2,1178.79,43,3,2,3,8,Other
16346,1,224.51,384,1,1,1,3,At-Risk
16347,11,3442.96,10,4,4,4,12,High-Value
16348,8,1742.08,31,3,4,3,10,High-Value
16349,1,53.5,290,2,1,1,4,One-Time
16350,9,2253.89,20,4,4,4,12,High-Value
16351,13,3330.03,332,2,4,4,10,High-Value
16352,2,494.44,17,4,2,2,8,Other
16353,38,9795.460000000001,3,4,4,4,12,High-Value
16354,5,1119.46,62,3,3,3,9,High-Value
16355,1,416.35,374,2,1,2,5,Other
16356,6,415.87,197,2,3,2,7,Other
16357,4,868.37,32,3,3,3,9,High-Value
16358,5,2919.65,0,4,3,4,11,High-Value
16359,16,2697.75,6,4,4,4,12,High-Value
16360,6,3450.41,4,4,3,4,11,High-Value
16361,4,891.21,9,4,3,3,10,High-Value
16362,6,922.16,31,3,3,3,9,High-Value
16363,1,109.36000000000001,52,3,1,1,5,One-Time
16364,2,705.79,11,4,2,2,8,Other
16365,15,3167.34,17,4,4,4,12,High-Value
16366,4,1548.13,18,4,3,3,10,High-Value
16367,3,1350.48,36,3,3,3,9,High-Value
16368,3,621.44,1,4,3,2,9,High-Value
16369,7,2654.48,17,4,4,4,12,High-Value
16370,4,1301.91,81,3,3,3,9,High-Value
16371,1,157.2,448,1,1,1,3,At-Risk
16372,5,1290.31,32,3,3,3,9,High-Value
16373,2,309.49,381,1,2,1,4,At-Risk
16374,5,1709.55,65,3,3,3,9,High-Value
16375,2,104.0,469,1,2,1,4,At-Risk
16376,2,974.96,8,4,2,3,9,High-Value
16377,2,1308.48,266,2,2,3,7,Other
16378,3,362.95,246,2,3,2,7,Other
16379,4,2157.4,3,4,3,3,10,High-Value
16380,1,1743.15,60,3,1,3,7,Other
16381,2,247.85,395,1,2,1,4,At-Risk
16382,2,353.1,407,1,2,2,5,At-Risk
16383,7,2887.99,74,3,4,4,11,High-Value
16384,4,1358.95,89,3,3,3,9,High-Value
16385,5,881.35,59,3,3,3,9,High-Value
16386,3,1068.16,28,3,3,3,9,High-Value
16387,5,882.46,322,2,3,3,8,Other
16388,1,186.05,653,1,1,1,3,At-Risk
16389,4,1382.07,52,3,3,3,9,High-Value
16390,3,467.5,536,1,3,2,6,At-Risk
16391,4,1048.86,400,1,3,3,7,At-Risk
16392,3,755.45,269,2,3,2,7,Other
16393,23,5297.77,1,4,4,4,12,High-Value
16394,5,1555.34,56,3,3,3,9,High-Value
16395,14,3517.56,60,3,4,4,11,High-Value
16396,1,137.8,475,1,1,1,3,At-Risk
16397,1,123.13,627,1,1,1,3,At-Risk
16398,2,1705.8,153,2,2,3,7,Other
16399,3,628.42,18,4,3,2,9,High-Value
16400,9,3059.85,94,3,4,4,11,High-Value
16401,23,6847.45,0,4,4,4,12,High-Value
16402,2,293.45,264,2,2,1,5,Other
16403,1,177.5,311,2,1,1,4,One-Time
16404,1,443.05,69,3,1,2,6,Other
16405,2,167.25,301,2,2,1,5,Other
16406,3,528.36,18,4,3,2,9,High-Value
16407,14,2761.65,12,4,4,4,12,High-Value
16408,1,231.93,590,1,1,1,3,At-Risk
16409,12,5652.74,35,3,4,4,11,High-Value
16410,1,130.32,733,1,1,1,3,At-Risk
16411,4,756.39,18,4,3,2,9,High-Value
16412,5,593.19,53,3,3,2,8,Loyal
16413,2,522.03,56,3,2,2,7,Other
16414,5,551.21,21,4,3,2,9,High-Value
16415,3,696.76,43,3,3,2,8,Loyal
16416,9,2957.88,26,3,4,4,11,High-Value
16417,1,35.7,492,1,1,1,3,At-Risk
16418,5,1028.74,44,3,3,3,9,High-Value
16419,8,1463.7,112,2,4,3,9,High-Value
16420,1,75.0,395,1,1,1,3,At-Risk
16421,3,526.27,375,2,3,2,7,Other
16422,108,61728.87,16,4,4,4,12,High-Value
16423,1,346.12,24,4,1,2,7,Other
16424,2,443.06,190,2,2,2,6,Other
16425,1,302.7,301,2,1,1,4,One-Time
16426,10,1863.76,1,4,4,3,11,High-Value
16427,2,241.06,262,2,2,1,5,Other
16428,3,638.49,413,1,3,2,6,At-Risk
16429,1,284.55,105,2,1,1,4,One-Time
16430,6,1102.94,56,3,3,3,9,High-Value
16431,3,623.28,212,2,3,2,7,Other
16432,1,287.40000000000003,63,3,1,1,5,One-Time
16433,2,384.52,27,3,2,2,7,Other
16434,12,2673.69,28,3,4,4,11,High-Value
16435,3,1003.07,511,1,3,3,7,At-Risk
16436,3,319.14,667,1,3,1,5,At-Risk
16437,2,301.25,380,1,2,1,4,At-Risk
16438,5,798.35,5,4,3,2,9,High-Value
16439,1,310.70000000000005,721,1,1,1,3,At-Risk
16440,6,3856.9700000000003,7,4,3,4,11,High-Value
16441,5,1013.1800000000001,66,3,3,3,9,High-Value
16442,5,891.98,1,4,3,3,10,High-Value
16443,1,162.24,520,1,1,1,3,At-Risk
16444,17,3625.88,45,3,4,4,11,High-Value
16445,4,583.16,33,3,3,2,8,Loyal
16446,2,168472.5,0,4,2,4,10,High-Value
16447,3,727.1,135,2,3,2,7,Other
16448,2,361.12,197,2,2,2,6,Other
16449,2,707.69,197,2,2,2,6,Other
16450,3,1505.73,149,2,3,3,8,Other
16451,3,1013.15,87,3,3,3,9,High-Value
16452,2,332.17,630,1,2,1,4,At-Risk
16453,2,251.71,530,1,2,1,4,At-Risk
16454,3,29.950000000000003,63,3,3,1,7,Loyal
16455,11,3995.57,63,3,4,4,11,High-Value
16456,13,6000.94,98,2,4,4,10,High-Value
16457,1,208.36,217,2,1,1,4,One-Time
16458,30,5690.89,2,4,4,4,12,High-Value
16459,1,71.79,729,1,1,1,3,At-Risk
16460,3,811.23,27,3,3,2,8,Loyal
16461,3,1539.83,177,2,3,3,8,Other
16462,3,136.0,73,3,3,1,7,Loyal
16463,4,1422.4,20,4,3,3,10,High-Value
16464,3,1298.66,19,4,3,3,10,High-Value
16465,2,746.24,420,1,2,2,5,At-Risk
16466,15,3767.09,33,3,4,4,11,High-Value
16467,7,2869.16,508,1,4,4,9,High-Value
16468,3,787.52,73,3,3,2,8,Loyal
16469,5,803.9,23,4,3,2,9,High-Value
16470,11,2416.85,51,3,4,4,11,High-Value
16471,4,1189.98,274,2,3,3,8,Other
16472,2,789.6,433,1,2,2,5,At-Risk
16473,4,470.83,164,2,3,2,7,Other
16474,7,1810.49,6,4,4,3,11,High-Value
16475,4,544.3000000000001,87,3,3,2,8,Loyal
16476,1,350.35,431,1,1,2,4,At-Risk
16477,11,4094.3700000000003,63,3,4,4,11,High-Value
16478,3,331.0,24,4,3,1,8,Loyal
16479,2,300.83,9,4,2,1,7,Other
16480,1,769.29,75,3,1,2,6,Other
16481,1,453.38,681,1,1,2,4,At-Risk
16482,1,220.62,15,4,1,1,6,One-Time
16483,1,139.35,191,2,1,1,4,One-Time
16484,2,404.3,173,2,2,2,6,Other
16485,5,2287.19,76,3,3,4,10,High-Value
16486,1,134.36,537,1,1,1,3,At-Risk
16487,2,209.4,576,1,2,1,4,At-Risk
16488,3,498.8,32,3,3,2,8,Loyal
16489,2,303.7,379,1,2,1,4,At-Risk
16490,1,205.41000000000003,435,1,1,1,3,At-Risk
16491,2,1533.16,46,3,2,3,8,Other
16492,1,385.56,540,1,1,2,4,At-Risk
16493,7,2132.09,79,3,4,3,10,High-Value
16494,1,826.53,296,2,1,2,5,Other
16495,3,648.26,2,4,3,2,9,High-Value
16496,6,2330.77,8,4,3,4,11,High-Value
16497,23,6695.28,49,3,4,4,11,High-Value
16498,2,100.97,160,2,2,1,5,Other
16499,8,2578.34,359,2,4,4,10,High-Value
16500,9,843.9100000000001,4,4,4,2,10,High-Value
16501,1,1191.23,382,1,1,3,5,At-Risk
16502,2,258.55,619,1,2,1,4,At-Risk
16503,11,3614.34,106,2,4,4,10,High-Value
16504,1,465.88,24,4,1,2,7,Other
16505,1,777.6,31,3,1,2,6,Other
16506,2,90.30000000000001,19,4,2,1,7,Other
16507,1,142.71,571,1,1,1,3,At-Risk
16508,1,240.95,629,1,1,1,3,At-Risk
16509,1,363.70000000000005,296,2,1,2,5,Other
16510,6,1757.25,371,2,3,3,8,Other
16511,6,1758.49,21,4,3,3,10,High-Value
16513,4,874.59,4,4,3,3,10,High-Value
16515,10,3179.06,51,3,4,4,11,High-Value
16516,1,101.69999999999999,29,3,1,1,5,One-Time
16517,1,162.7,276,2,1,1,4,One-Time
16518,4,959.37,60,3,3,3,9,High-Value
16519,4,436.96000000000004,24,4,3,2,9,High-Value
16520,6,2148.38,185,2,3,3,8,Other
16521,3,1136.36,414,1,3,3,7,At-Risk
16522,2,433.36,435,1,2,2,5,At-Risk
16523,28,11916.33,1,4,4,4,12,High-Value
16524,2,306.19,445,1,2,1,4,At-Risk
16525,48,24151.3,1,4,4,4,12,High-Value
16526,2,717.21,171,2,2,2,6,Other
16527,2,1232.94,80,3,2,3,8,Other
16528,1,244.41,3,4,1,1,6,One-Time
16529,4,1986.8,189,2,3,3,8,Other
16530,1,48.35,667,1,1,1,3,At-Risk
16531,11,2298.33,21,4,4,4,12,High-Value
16532,5,8756.64,17,4,3,4,11,High-Value
16533,3,1082.81,18,4,3,3,10,High-Value
16534,1,635.9,641,1,1,2,4,At-Risk
16535,2,952.04,4,4,2,3,9,High-Value
16536,1,548.12,109,2,1,2,5,Other
16537,1,10.55,640,1,1,1,3,At-Risk
16538,3,395.07,540,1,3,2,6,At-Risk
16539,10,3289.66,2,4,4,4,12,High-Value
16540,1,205.75,413,1,1,1,3,At-Risk
16541,1,424.03000000000003,734,1,1,2,4,At-Risk
16542,2,257.32,53,3,2,1,6,Other
16543,1,292.21,591,1,1,1,3,At-Risk
16544,4,376.70000000000005,519,1,3,2,6,At-Risk
16545,2,689.82,164,2,2,2,6,Other
16546,5,5307.07,290,2,3,4,9,High-Value
16547,1,104.25999999999999,545,1,1,1,3,At-Risk
16548,1,30.150000000000002,598,1,1,1,3,At-Risk
16549,34,12781.8,9,4,4,4,12,High-Value
16550,18,8807.68,108,2,4,4,10,High-Value
16551,7,2237.12,95,2,4,3,9,High-Value
16552,2,379.73,242,2,2,2,6,Other
16553,33,16584.01,162,2,4,4,10,High-Value
16554,8,2841.7200000000003,41,3,4,4,11,High-Value
16555,6,1915.68,34,3,3,3,9,High-Value
16556,17,8012.58,66,3,4,4,11,High-Value
16557,2,281.85,23,4,2,1,7,Other
16558,38,13304.11,0,4,4,4,12,High-Value
16559,1,175.0,396,1,1,1,3,At-Risk
16560,8,3048.38,26,3,4,4,11,High-Value
16561,2,511.12,5,4,2,2,8,Other
16562,1,223.86,476,1,1,1,3,At-Risk
16563,6,4412.56,53,3,3,4,10,High-Value
16564,1,87.80000000000001,568,1,1,1,3,At-Risk
16565,4,773.05,363,2,3,2,7,Other
16566,5,614.66,14,4,3,2,9,High-Value
16567,2,865.6,193,2,2,3,7,Other
16568,2,1020.9,427,1,2,3,6,At-Risk
16569,5,1455.23,2,4,3,3,10,High-Value
16570,20,7434.31,14,4,4,4,12,High-Value
16571,10,4248.74,26,3,4,4,11,High-Value
16572,3,1009.6,126,2,3,3,8,Other
16573,2,663.61,84,3,2,2,7,Other
16574,3,1301.78,70,3,3,3,9,High-Value
16576,2,540.87,419,1,2,2,5,At-Risk
16577,1,380.0,666,1,1,2,4,At-Risk
16578,1,156.60000000000002,625,1,1,1,3,At-Risk
16579,1,295.05,425,1,1,1,3,At-Risk
16581,1,105.84,182,2,1,1,4,One-Time
16582,1,313.62,112,2,1,1,4,One-Time
16583,2,297.95,373,2,2,1,5,Other
16584,5,3156.17,79,3,3,4,10,High-Value
16585,2,341.59000000000003,593,1,2,2,5,At-Risk
16586,3,1462.78,248,2,3,3,8,Other
16587,1,225.15,231,2,1,1,4,One-Time
16588,4,1361.28,385,1,3,3,7,At-Risk
16589,4,612.36,70,3,3,2,8,Loyal
16590,2,605.9,400,1,2,2,5,At-Risk
16591,1,213.5,68,3,1,1,5,One-Time
16592,28,7807.91,3,4,4,4,12,High-Value
16593,8,1071.14,50,3,4,3,10,High-Value
16594,1,181.09,74,3,1,1,5,One-Time
16595,5,1757.75,60,3,3,3,9,High-Value
16596,4,458.98,15,4,3,2,9,High-Value
16597,1,90.04,3,4,1,1,6,One-Time
16598,1,145.04999999999998,285,2,1,1,4,One-Time
16599,1,172.8,385,1,1,1,3,At-Risk
16600,13,2153.41,3,4,4,3,11,High-Value
16601,3,675.83,40,3,3,2,8,Loyal
16602,2,763.33,35,3,2,2,7,Other
16603,2,482.47,74,3,2,2,7,Other
16604,2,432.45000000000005,562,1,2,2,5,At-Risk
16605,1,60.48,723,1,1,1,3,At-Risk
16606,2,357.66,403,1,2,2,5,At-Risk
16607,25,5706.87,17,4,4,4,12,High-Value
16608,2,1286.6200000000001,453,1,2,3,6,At-Risk
16609,7,5493.46,14,4,4,4,12,High-Value
16610,1,75.66,218,2,1,1,4,One-Time
16611,6,1785.13,185,2,3,3,8,Other
16612,9,3245.4300000000003,32,3,4,4,11,High-Value
16613,1,618.59,69,3,1,2,6,Other
16614,3,1179.79,182,2,3,3,8,Other
16615,1,291.5,625,1,1,1,3,At-Risk
16616,2,500.42,14,4,2,2,8,Other
16617,1,151.85,235,2,1,1,4,One-Time
16618,5,2647.59,30,3,3,4,10,High-Value
16619,4,1938.3300000000002,263,2,3,3,8,Other
16620,6,1758.93,3,4,3,3,10,High-Value
16621,4,813.48,51,3,3,2,8,Loyal
16622,1,225.4,543,1,1,1,3,At-Risk
16623,4,1015.24,245,2,3,3,8,Other
16624,2,810.5699999999999,80,3,2,2,7,Other
16625,5,1654.03,274,2,3,3,8,Other
16626,17,4413.1,0,4,4,4,12,High-Value
16627,1,322.8,78,3,1,1,5,One-Time
16628,7,2318.1,29,3,4,4,11,High-Value
16629,2,408.63,73,3,2,2,7,Other
16630,1,106.80000000000001,406,1,1,1,3,At-Risk
16631,7,1892.52,481,1,4,3,8,At-Risk
16632,2,406.4,485,1,2,2,5,At-Risk
16633,6,2883.1,16,4,3,4,11,High-Value
16634,6,1649.81,222,2,3,3,8,Other
16635,1,473.0,406,1,1,2,4,At-Risk
16636,4,3802.04,437,1,3,4,8,At-Risk
16637,4,1154.47,31,3,3,3,9,High-Value
16638,15,2380.13,22,4,4,4,12,High-Value
16639,4,1747.98,30,3,3,3,9,High-Value
16640,1,179.4,397,1,1,1,3,At-Risk
16641,2,554.5,105,2,2,2,6,Other
16642,3,1077.45,4,4,3,3,10,High-Value
16643,2,923.11,245,2,2,3,7,Other
16644,2,833.78,177,2,2,2,6,Other
16645,1,160.39,735,1,1,1,3,At-Risk
16646,1,678.8,448,1,1,2,4,At-Risk
16647,4,541.9,169,2,3,2,7,Other
16648,3,672.8,42,3,3,2,8,Loyal
16649,1,306.58,519,1,1,1,3,At-Risk
16650,7,1916.11,71,3,4,3,10,High-Value
16651,1,136.2,586,1,1,1,3,At-Risk
16652,16,17550.39,58,3,4,4,11,High-Value
16653,2,1212.66,15,4,2,3,9,High-Value
16654,8,1484.07,140,2,4,3,9,High-Value
16655,13,6423.26,17,4,4,4,12,High-Value
16656,30,16833.170000000002,21,4,4,4,12,High-Value
16657,4,874.43,9,4,3,3,10,High-Value
16658,5,680.83,367,2,3,2,7,Other
16659,1,39.12,188,2,1,1,4,One-Time
16660,7,1879.55,15,4,4,3,11,High-Value
16661,4,932.76,539,1,3,3,7,At-Risk
16662,1,151.05,393,1,1,1,3,At-Risk
16663,1,165.0,728,1,1,1,3,At-Risk
16664,1,109.2,568,1,1,1,3,At-Risk
16665,1,135.4,361,2,1,1,4,One-Time
16666,2,217.71,18,4,2,1,7,Other
16667,2,567.1800000000001,67,3,2,2,7,Other
16668,13,862.42,14,4,4,3,11,High-Value
16669,2,1344.48,23,4,2,3,9,High-Value
16670,20,8030.150000000001,16,4,4,4,12,High-Value
16671,3,1692.27,27,3,3,3,9,High-Value
16672,20,8134.9400000000005,1,4,4,4,12,High-Value
16673,1,171.13,678,1,1,1,3,At-Risk
16674,2,304.24,54,3,2,1,6,Other
16675,2,608.86,441,1,2,2,5,At-Risk
16676,6,2361.9,33,3,3,4,10,High-Value
16677,2,880.62,410,1,2,3,6,At-Risk
16678,12,3109.99,2,4,4,4,12,High-Value
16679,3,663.31,365,2,3,2,7,Other
16680,3,821.45,42,3,3,2,8,Loyal
16681,7,1921.8400000000001,72,3,4,3,10,High-Value
16682,5,1028.0,4,4,3,3,10,High-Value
16683,1,320.25,533,1,1,1,3,At-Risk
16684,55,147142.77,3,4,4,4,12,High-Value
16685,2,324.24,60,3,2,1,6,Other
16686,16,4881.07,46,3,4,4,11,High-Value
16687,1,157.63,390,1,1,1,3,At-Risk
16688,4,1260.86,0,4,3,3,10,High-Value
16689,2,422.6,75,3,2,2,7,Other
16690,4,353.03000000000003,71,3,3,2,8,Loyal
16691,2,178.83,417,1,2,1,4,At-Risk
16692,4,1764.6999999999998,255,2,3,3,8,Other
16693,5,1179.48,68,3,3,3,9,High-Value
16694,1,98.30000000000001,722,1,1,1,3,At-Risk
16695,2,191.9,561,1,2,1,4,At-Risk
16696,4,657.9,134,2,3,2,7,Other
16697,1,112.75,240,2,1,1,4,One-Time
16698,2,1998.0,226,2,2,3,7,Other
16699,7,994.6,379,1,4,3,8,At-Risk
16700,25,8830.77,8,4,4,4,12,High-Value
16701,26,9916.73,8,4,4,4,12,High-Value
16702,4,1109.53,414,1,3,3,7,At-Risk
16704,2,664.16,617,1,2,2,5,At-Risk
16705,42,43515.051,0,4,4,4,12,High-Value
16706,3,531.35,36,3,3,2,8,Loyal
16707,4,533.41,399,1,3,2,6,At-Risk
16708,1,656.63,45,3,1,2,6,Other
16709,14,9056.01,84,3,4,4,11,High-Value
16710,22,5921.35,18,4,4,4,12,High-Value
16711,9,2868.48,2,4,4,4,12,High-Value
16712,13,4225.22,8,4,4,4,12,High-Value
16713,32,14115.56,18,4,4,4,12,High-Value
16714,3,1482.33,316,2,3,3,8,Other
16715,2,625.52,77,3,2,2,7,Other
16716,3,2149.6800000000003,266,2,3,3,8,Other
16717,14,6663.68,23,4,4,4,12,High-Value
16718,5,3006.08,368,2,3,4,9,High-Value
16719,14,3508.62,14,4,4,4,12,High-Value
16720,3,566.74,25,3,3,2,8,Loyal
16721,1,292.47,261,2,1,1,4,One-Time
16722,22,8189.56,16,4,4,4,12,High-Value
16723,4,1231.36,90,3,3,3,9,High-Value
16724,1,147.35,404,1,1,1,3,At-Risk
16725,13,1686.81,301,2,4,3,9,High-Value
16726,7,2063.88,25,3,4,3,10,High-Value
16727,4,1377.77,363,2,3,3,8,Other
16728,4,1048.28,45,3,3,3,9,High-Value
16729,21,7202.01,37,3,4,4,11,High-Value
16730,3,743.11,51,3,3,2,8,Loyal
16731,1,170.3,647,1,1,1,3,At-Risk
16732,4,4387.64,31,3,3,4,10,High-Value
16733,1,259.68,529,1,1,1,3,At-Risk
16734,3,646.76,51,3,3,2,8,Loyal
16735,14,6217.41,78,3,4,4,11,High-Value
16736,5,2956.56,505,1,3,4,8,At-Risk
16737,2,835.2,52,3,2,2,7,Other
16738,1,3.75,297,2,1,1,4,One-Time
16739,2,786.4300000000001,176,2,2,2,6,Other
16740,1,226.91,394,1,1,1,3,At-Risk
16741,1,173.06,624,1,1,1,3,At-Risk
16742,13,2334.97,492,1,4,4,9,High-Value
16743,14,4212.15,28,3,4,4,11,High-Value
16744,7,1291.91,10,4,4,3,11,High-Value
16745,17,7180.7,86,3,4,4,11,High-Value
16746,42,18045.05,4,4,4,4,12,High-Value
16747,2,836.0600000000001,37,3,2,2,7,Other
16748,14,3637.33,17,4,4,4,12,High-Value
16749,2,4157.88,590,1,2,4,7,At-Risk
16750,5,623.9300000000001,44,3,3,2,8,Loyal
16751,1,1764.72,30,3,1,3,7,Other
16752,1,207.5,372,2,1,1,4,One-Time
16753,1,223.92000000000002,57,3,1,1,5,One-Time
16754,29,65500.07,371,2,4,4,10,High-Value
16755,7,2864.68,113,2,4,4,10,High-Value
16756,7,1312.3700000000001,214,2,4,3,9,High-Value
16757,2,270.48,318,2,2,1,5,Other
16758,1,369.34,64,3,1,2,6,Other
16759,3,789.79,7,4,3,2,9,High-Value
16760,1,228.0,429,1,1,1,3,At-Risk
16761,1,316.62,96,2,1,1,4,One-Time
16762,3,1207.24,19,4,3,3,10,High-Value
16763,2,964.6999999999999,198,2,2,3,7,Other
16764,13,2790.95,3,4,4,4,12,High-Value
16765,2,454.75,293,2,2,2,6,Other
16766,2,1145.6,272,2,2,3,7,Other
16767,15,8052.41,30,3,4,4,11,High-Value
16768,9,1698.57,47,3,4,3,10,High-Value
16769,4,1117.05,259,2,3,3,8,Other
16770,9,1778.93,57,3,4,3,10,High-Value
16771,10,3921.1,32,3,4,4,11,High-Value
16772,3,3698.0499999999997,422,1,3,4,8,At-Risk
16773,3,421.24,56,3,3,2,8,Loyal
16774,8,1567.48,67,3,4,3,10,High-Value
16775,16,2820.84,9,4,4,4,12,High-Value
16776,2,592.51,59,3,2,2,7,Other
16777,5,1292.18,79,3,3,3,9,High-Value
16778,2,245.94,73,3,2,1,6,Other
16779,53,32809.03,1,4,4,4,12,High-Value
16780,3,596.4,99,2,3,2,7,Other
16781,2,623.0,371,2,2,2,6,Other
16782,38,9636.12,9,4,4,4,12,High-Value
16783,1,391.95,436,1,1,2,4,At-Risk
16784,5,892.33,19,4,3,3,10,High-Value
16785,1,533.78,409,1,1,2,4,At-Risk
16786,1,51.84,393,1,1,1,3,At-Risk
16787,4,1017.53,397,1,3,3,7,At-Risk
16788,5,1927.28,122,2,3,3,8,Other
16789,1,80.80000000000001,7,4,1,1,6,One-Time
16790,6,1545.6200000000001,3,4,3,3,10,High-Value
16791,15,3944.88,28,3,4,4,11,High-Value
16792,5,623.46,281,2,3,2,7,Other
16793,1,243.84,56,3,1,1,5,One-Time
16794,15,2050.68,0,4,4,3,11,High-Value
16795,3,2062.41,364,2,3,3,8,Other
16796,1,305.62,88,3,1,1,5,One-Time
16797,5,1802.02,392,1,3,3,7,At-Risk
16798,3,841.16,553,1,3,2,6,At-Risk
16799,2,452.78000000000003,431,1,2,2,5,At-Risk
16800,1,1162.65,10,4,1,3,8,Other
16801,4,1594.23,162,2,3,3,8,Other
16802,2,582.61,678,1,2,2,5,At-Risk
16803,1,332.3,64,3,1,1,5,One-Time
16804,3,536.99,22,4,3,2,9,High-Value
16805,4,1076.34,173,2,3,3,8,Other
16806,4,736.21,102,2,3,2,7,Other
16807,6,2123.88,142,2,3,3,8,Other
16808,2,288.42,98,2,2,1,5,Other
16809,9,1727.43,22,4,4,3,11,High-Value
16810,2,842.0400000000001,191,2,2,2,6,Other
16811,2,547.07,4,4,2,2,8,Other
16812,4,2392.0,360,2,3,4,9,High-Value
16813,10,1652.18,7,4,4,3,11,High-Value
16814,36,11914.95,13,4,4,4,12,High-Value
16815,2,406.02,453,1,2,2,5,At-Risk
16816,4,417.06,102,2,3,2,7,Other
16817,13,2560.7,2,4,4,4,12,High-Value
16818,11,3349.57,10,4,4,4,12,High-Value
16819,2,182.59,464,1,2,1,4,At-Risk
16820,1,497.61,95,2,1,2,5,Other
16821,1,113.35,381,1,1,1,3,At-Risk
16822,1,181.39,685,1,1,1,3,At-Risk
16823,7,2243.09,226,2,4,4,10,High-Value
16824,3,686.24,15,4,3,2,9,High-Value
16825,5,1826.89,38,3,3,3,9,High-Value
16826,1,341.7,50,3,1,2,6,Other
16827,5,387.18,392,1,3,2,6,At-Risk
16828,1,113.5,111,2,1,1,4,One-Time
16829,2,513.32,156,2,2,2,6,Other
16830,4,1207.5,38,3,3,3,9,High-Value
16831,1,91.8,564,1,1,1,3,At-Risk
16832,5,417.61,183,2,3,2,7,Other
16833,6,2409.04,0,4,3,4,11,High-Value
16834,2,898.96,227,2,2,3,7,Other
16835,6,1456.66,127,2,3,3,8,Other
16836,4,782.37,39,3,3,2,8,Loyal
16837,11,3170.98,30,3,4,4,11,High-Value
16838,4,1159.6100000000001,196,2,3,3,8,Other
16839,44,21758.25,8,4,4,4,12,High-Value
16840,2,139.85,602,1,2,1,4,At-Risk
16841,12,4006.06,36,3,4,4,11,High-Value
16842,3,1264.19,100,2,3,3,8,Other
16843,35,19571.43,42,3,4,4,11,High-Value
16844,2,614.34,562,1,2,2,5,At-Risk
16845,1,253.88,617,1,1,1,3,At-Risk
16846,3,842.41,49,3,3,2,8,Loyal
16847,2,614.89,42,3,2,2,7,Other
16848,4,1411.6200000000001,52,3,3,3,9,High-Value
16849,1,124.57,186,2,1,1,4,One-Time
16850,1,332.41,333,2,1,1,4,One-Time
16851,3,342.45,3,4,3,2,9,High-Value
16852,2,144.91,9,4,2,1,7,Other
16854,2,1408.96,416,1,2,3,6,At-Risk
16855,2,328.40000000000003,23,4,2,1,7,Other
16856,3,358.49,14,4,3,2,9,High-Value
16857,1,352.8,442,1,1,2,4,At-Risk
16858,10,4292.59,368,2,4,4,10,High-Value
16859,7,1932.41,144,2,4,3,9,High-Value
16860,3,1610.62,452,1,3,3,7,At-Risk
16861,5,946.59,59,3,3,3,9,High-Value
16862,4,662.33,546,1,3,2,6,At-Risk
16863,3,834.27,30,3,3,2,8,Loyal
16864,2,409.25,433,1,2,2,5,At-Risk
16865,1,130.95,401,1,1,1,3,At-Risk
16866,3,207.74,140,2,3,1,6,Other
16867,1,76.74000000000001,689,1,1,1,3,At-Risk
16868,3,384.56,393,1,3,2,6,At-Risk
16869,4,817.12,22,4,3,2,9,High-Value
16870,1,450.16,468,1,1,2,4,At-Risk
16871,6,2812.34,21,4,3,4,11,High-Value
16872,6,1213.13,76,3,3,3,9,High-Value
16873,12,14617.39,4,4,4,4,12,High-Value
16874,1,209.89000000000001,378,2,1,1,4,One-Time
16875,11,4234.53,66,3,4,4,11,High-Value
16876,1,136.01,403,1,1,1,3,At-Risk
16877,6,846.62,11,4,3,2,9,High-Value
16878,1,13.3,83,3,1,1,5,One-Time
16880,8,1813.21,30,3,4,3,10,High-Value
16881,1,432.0,66,3,1,2,6,Other
16882,3,705.12,66,3,3,2,8,Loyal
16883,19,2246.06,186,2,4,4,10,High-Value
16884,4,1070.97,37,3,3,3,9,High-Value
16885,4,683.35,14,4,3,2,9,High-Value
16886,1,134.0,455,1,1,1,3,At-Risk
16887,3,658.17,34,3,3,2,8,Loyal
16888,3,434.2,400,1,3,2,6,At-Risk
16889,6,2526.65,194,2,3,4,9,High-Value
16890,3,277.91,476,1,3,1,5,At-Risk
16891,11,1727.94,1,4,4,3,11,High-Value
16892,7,754.75,0,4,4,2,10,High-Value
16893,2,249.47,366,2,2,1,5,Other
16894,3,1306.96,501,1,3,3,7,At-Risk
16895,5,1102.9,64,3,3,3,9,High-Value
16896,1,103.95,554,1,1,1,3,At-Risk
16897,2,289.78,298,2,2,1,5,Other
16898,5,885.21,25,3,3,3,9,High-Value
16899,8,1695.77,7,4,4,3,11,High-Value
16900,3,882.16,16,4,3,3,10,High-Value
16901,1,204.26,728,1,1,1,3,At-Risk
16902,1,1706.88,115,2,1,3,6,Other
16903,3,1041.75,28,3,3,3,9,High-Value
16904,20,4656.56,3,4,4,4,12,High-Value
16905,17,4704.27,4,4,4,4,12,High-Value
16906,7,1410.07,81,3,4,3,10,High-Value
16907,9,1470.89,28,3,4,3,10,High-Value
16908,1,252.59,721,1,1,1,3,At-Risk
16909,1,379.14,71,3,1,2,6,Other
16910,8,1508.96,3,4,4,3,11,High-Value
16911,2,255.25,635,1,2,1,4,At-Risk
16912,15,4460.51,28,3,4,4,11,High-Value
16913,3,423.90999999999997,289,2,3,2,7,Other
16914,1,183.76,35,3,1,1,5,One-Time
16915,11,1543.18,8,4,4,3,11,High-Value
16916,4,896.12,23,4,3,3,10,High-Value
16917,2,1851.88,276,2,2,3,7,Other
16918,16,3206.54,49,3,4,4,11,High-Value
16919,24,4909.66,155,2,4,4,10,High-Value
16920,1,355.45,410,1,1,2,4,At-Risk
16921,3,409.21,60,3,3,2,8,Loyal
16922,1,611.08,572,1,1,2,4,At-Risk
16923,32,13157.130000000001,11,4,4,4,12,High-Value
16924,3,829.89,20,4,3,2,9,High-Value
16925,1,125.65,539,1,1,1,3,At-Risk
16926,5,1169.61,370,2,3,3,8,Other
16927,3,543.05,115,2,3,2,7,Other
16928,26,3798.08,79,3,4,4,11,High-Value
16929,7,1295.39,3,4,4,3,11,High-Value
16930,3,378.89,25,3,3,2,8,Loyal
16931,23,5032.22,4,4,4,4,12,High-Value
16932,3,412.55,52,3,3,2,8,Loyal
16933,9,3099.3,0,4,4,4,12,High-Value
16934,6,2083.14,54,3,3,3,9,High-Value
16935,3,530.86,381,1,3,2,6,At-Risk
16936,2,548.29,25,3,2,2,7,Other
16937,1,196.25,498,1,1,1,3,At-Risk
16938,9,6995.360000000001,8,4,4,4,12,High-Value
16939,3,433.85,488,1,3,2,6,At-Risk
16940,8,6427.66,51,3,4,4,11,High-Value
16941,1,33.0,611,1,1,1,3,At-Risk
16942,9,1904.99,12,4,4,3,11,High-Value
16943,3,816.73,211,2,3,2,7,Other
16944,1,101.36,609,1,1,1,3,At-Risk
16945,33,8548.16,21,4,4,4,12,High-Value
16946,5,1222.04,382,1,3,3,7,At-Risk
16947,4,946.71,235,2,3,3,8,Other
16948,7,868.77,138,2,4,3,9,High-Value
16949,6,1286.27,3,4,3,3,10,High-Value
16950,10,3533.77,56,3,4,4,11,High-Value
16951,3,1277.75,134,2,3,3,8,Other
16952,5,795.83,108,2,3,2,7,Other
16953,1,20.8,29,3,1,1,5,One-Time
16954,20,6081.88,0,4,4,4,12,High-Value
16955,6,1120.31,184,2,3,3,8,Other
16956,1,308.74,17,4,1,1,6,One-Time
16957,2,416.64,238,2,2,2,6,Other
16958,1,778.49,434,1,1,2,4,At-Risk
16959,1,117.35,86,3,1,1,5,One-Time
16960,8,1988.93,38,3,4,3,10,High-Value
16961,3,794.56,115,2,3,2,7,Other
16962,1,251.04,409,1,1,1,3,At-Risk
16963,1,110.55000000000001,186,2,1,1,4,One-Time
16964,2,207.85,732,1,2,1,4,At-Risk
16965,1,192.07,226,2,1,1,4,One-Time
16966,7,2154.97,7,4,4,3,11,High-Value
16967,1,319.02,188,2,1,1,4,One-Time
16968,2,439.43,3,4,2,2,8,Other
16969,3,650.41,38,3,3,2,8,Loyal
16970,1,71.4,625,1,1,1,3,At-Risk
16971,1,357.21,37,3,1,2,6,Other
16972,2,749.0,382,1,2,2,5,At-Risk
16973,1,127.0,385,1,1,1,3,At-Risk
16974,2,365.5,522,1,2,2,5,At-Risk
16975,3,926.12,422,1,3,3,7,At-Risk
16976,1,251.51999999999998,266,2,1,1,4,One-Time
16977,4,496.0,394,1,3,2,6,At-Risk
16978,3,768.88,77,3,3,2,8,Loyal
16979,9,2859.7400000000002,3,4,4,4,12,High-Value
16980,3,1422.83,254,2,3,3,8,Other
16982,1,384.06,60,3,1,2,6,Other
16983,11,3490.53,12,4,4,4,12,High-Value
16984,9,10350.53,87,3,4,4,11,High-Value
16985,23,10923.16,16,4,4,4,12,High-Value
16986,11,4888.75,29,3,4,4,11,High-Value
16987,11,2499.45,2,4,4,4,12,High-Value
16988,2,382.67,4,4,2,2,8,Other
16989,6,1133.25,6,4,3,3,10,High-Value
16990,2,344.0,218,2,2,2,6,Other
16991,1,1041.21,420,1,1,3,5,At-Risk
16992,13,5476.5,10,4,4,4,12,High-Value
16993,2,1950.95,463,1,2,3,6,At-Risk
16996,9,2123.61,29,3,4,3,10,High-Value
16997,3,702.0,287,2,3,2,7,Other
16998,5,402.0,149,2,3,2,7,Other
16999,2,484.82,22,4,2,2,8,Other
17000,2,406.3,395,1,2,2,5,At-Risk
17001,19,6640.8,0,4,4,4,12,High-Value
17002,7,2571.55,85,3,4,4,11,High-Value
17003,4,828.21,401,1,3,2,6,At-Risk
17004,4,2324.36,45,3,3,4,10,High-Value
17005,2,622.36,470,1,2,2,5,At-Risk
17006,8,1635.27,4,4,4,3,11,High-Value
17007,7,1120.1,50,3,4,3,10,High-Value
17008,1,81.36,428,1,1,1,3,At-Risk
17009,1,242.06,550,1,1,1,3,At-Risk
17010,1,195.36,17,4,1,1,6,One-Time
17011,3,671.7,29,3,3,2,8,Loyal
17012,1,360.61,724,1,1,2,4,At-Risk
17014,3,583.4300000000001,7,4,3,2,9,High-Value
17015,3,1838.6100000000001,28,3,3,3,9,High-Value
17016,1,552.4,576,1,1,2,4,At-Risk
17017,29,12576.99,2,4,4,4,12,High-Value
17018,6,2287.7,40,3,3,4,10,High-Value
17019,11,3586.9900000000002,10,4,4,4,12,High-Value
17020,2,935.62,541,1,2,3,6,At-Risk
17021,6,1182.22,441,1,3,3,7,At-Risk
17022,2,260.0,30,3,2,1,6,Other
17023,3,800.1800000000001,416,1,3,2,6,At-Risk
17024,3,95.85,44,3,3,1,7,Loyal
17025,5,1349.67,60,3,3,3,9,High-Value
17026,3,175.83,184,2,3,1,6,Other
17027,9,1310.63,78,3,4,3,10,High-Value
17028,3,1593.83,580,1,3,3,7,At-Risk
17029,7,2137.3,110,2,4,3,9,High-Value
17030,1,146.87,63,3,1,1,5,One-Time
17031,6,2773.85,11,4,3,4,11,High-Value
17032,5,2896.69,602,1,3,4,8,At-Risk
17033,4,1332.79,85,3,3,3,9,High-Value
17034,5,1276.42,15,4,3,3,10,High-Value
17035,4,613.59,245,2,3,2,7,Other
17036,1,176.9,382,1,1,1,3,At-Risk
17037,1,1267.32,87,3,1,3,7,Other
17038,2,743.17,29,3,2,2,7,Other
17039,1,1954.99,603,1,1,3,5,At-Risk
17040,2,463.25,137,2,2,2,6,Other
17041,6,1655.2,26,3,3,3,9,High-Value
17042,5,1036.58,2,4,3,3,10,High-Value
17043,8,2593.65,31,3,4,4,11,High-Value
17044,12,11962.300000000001,24,4,4,4,12,High-Value
17045,5,827.6800000000001,112,2,3,2,7,Other
17046,5,1906.07,156,2,3,3,8,Other
17047,6,2289.23,84,3,3,4,10,High-Value
17048,7,2071.6800000000003,117,2,4,3,9,High-Value
17049,19,9942.53,2,4,4,4,12,High-Value
17050,11,4648.59,95,2,4,4,10,High-Value
17051,4,706.49,193,2,3,2,7,Other
17052,1,399.09000000000003,27,3,1,2,6,Other
17053,1,498.48,130,2,1,2,5,Other
17054,5,1356.33,27,3,3,3,9,High-Value
17055,1,232.85,445,1,1,1,3,At-Risk
17056,1,128.60000000000002,737,1,1,1,3,At-Risk
17057,1,288.79,595,1,1,1,3,At-Risk
17058,3,1179.89,81,3,3,3,9,High-Value
17059,9,4864.57,29,3,4,4,11,High-Value
17060,1,234.24,265,2,1,1,4,One-Time
17061,11,5232.2300000000005,73,3,4,4,11,High-Value
17062,6,884.71,313,2,3,3,8,Other
17063,13,3638.53,20,4,4,4,12,High-Value
17064,3,855.45,58,3,3,2,8,Loyal
17065,2,194.70000000000002,637,1,2,1,4,At-Risk
17066,1,228.34,725,1,1,1,3,At-Risk
17067,3,454.54,724,1,3,2,6,At-Risk
17068,47,8980.18,11,4,4,4,12,High-Value
17069,14,5517.2300000000005,27,3,4,4,11,High-Value
17070,2,437.42,113,2,2,2,6,Other
17071,13,3793.71,27,3,4,4,11,High-Value
17072,1,273.35,624,1,1,1,3,At-Risk
17073,4,1444.84,17,4,3,3,10,High-Value
17074,1,203.05,562,1,1,1,3,At-Risk
17075,10,2236.63,17,4,4,3,11,High-Value
17076,6,1242.75,35,3,3,3,9,High-Value
17077,1,306.0,577,1,1,1,3,At-Risk
17078,2,375.86,35,3,2,2,7,Other
17079,1,118.80000000000001,77,3,1,1,5,One-Time
17080,7,957.53,21,4,4,3,11,High-Value
17081,6,949.39,24,4,3,3,10,High-Value
17082,6,4732.03,32,3,3,4,10,High-Value
17083,9,4049.79,108,2,4,4,10,High-Value
17084,3,5001.21,34,3,3,4,10,High-Value
17085,28,7839.27,122,2,4,4,10,High-Value
17086,6,2050.08,6,4,3,3,10,High-Value
17087,1,221.53,737,1,1,1,3,At-Risk
17088,4,1991.01,27,3,3,3,9,High-Value
17089,1,128.45,385,1,1,1,3,At-Risk
17090,13,3080.1800000000003,3,4,4,4,12,High-Value
17091,19,7495.75,2,4,4,4,12,High-Value
17092,11,5511.41,49,3,4,4,11,High-Value
17093,1,235.88,592,1,1,1,3,At-Risk
17094,2,402.20000000000005,321,2,2,2,6,Other
17095,7,2572.25,22,4,4,4,12,High-Value
17096,11,3697.93,14,4,4,4,12,High-Value
17097,9,1143.36,1,4,4,3,11,High-Value
17098,3,591.07,381,1,3,2,6,At-Risk
17099,1,582.17,532,1,1,2,4,At-Risk
17100,2,971.74,17,4,2,3,9,High-Value
17101,7,2507.05,9,4,4,4,12,High-Value
17102,1,25.5,261,2,1,1,4,One-Time
17103,1,424.3,721,1,1,2,4,At-Risk
17104,1,474.03000000000003,423,1,1,2,4,At-Risk
17105,2,665.78,158,2,2,2,6,Other
17106,1,481.58,388,1,1,2,4,At-Risk
17107,10,16052.72,32,3,4,4,11,High-Value
17108,1,174.95,663,1,1,1,3,At-Risk
17109,8,1291.71,28,3,4,3,10,High-Value
17110,3,499.9,164,2,3,2,7,Other
17111,2,459.58,46,3,2,2,7,Other
17112,1,197.57,502,1,1,1,3,At-Risk
17113,6,2305.59,573,1,3,4,8,At-Risk
17114,8,801.12,5,4,4,2,10,High-Value
17115,7,2761.4900000000002,7,4,4,4,12,High-Value
17116,1,389.78,647,1,1,2,4,At-Risk
17117,1,116.2,287,2,1,1,4,One-Time
17118,1,157.02,317,2,1,1,4,One-Time
17119,2,606.91,2,4,2,2,8,Other
17120,1,307.46,232,2,1,1,4,One-Time
17121,1,314.74,402,1,1,1,3,At-Risk
17122,4,570.5,118,2,3,2,7,Other
17123,3,966.6700000000001,161,2,3,3,8,Other
17124,1,294.24,184,2,1,1,4,One-Time
17125,1,230.5,49,3,1,1,5,One-Time
17126,9,2008.93,151,2,4,3,9,High-Value
17127,5,1155.0300000000002,428,1,3,3,7,At-Risk
17128,1,157.09,334,2,1,1,4,One-Time
17129,1,31.85,519,1,1,1,3,At-Risk
17131,5,2463.17,4,4,3,4,11,High-Value
17132,2,1220.91,451,1,2,3,6,At-Risk
17133,12,14622.33,15,4,4,4,12,High-Value
17134,3,625.3000000000001,106,2,3,2,7,Other
17135,10,1716.38,15,4,4,3,11,High-Value
17136,1,231.68,661,1,1,1,3,At-Risk
17137,6,1099.81,415,1,3,3,7,At-Risk
17138,7,4417.27,275,2,4,4,10,High-Value
17139,25,19566.76,15,4,4,4,12,High-Value
17140,1,454.12,246,2,1,2,5,Other
17141,4,727.58,417,1,3,2,6,At-Risk
17142,4,1275.25,238,2,3,3,8,Other
17143,2,880.97,416,1,2,3,6,At-Risk
17144,2,984.57,0,4,2,3,9,High-Value
17145,4,3120.91,512,1,3,4,8,At-Risk
17146,13,5852.64,105,2,4,4,10,High-Value
17147,9,3199.95,22,4,4,4,12,High-Value
17148,1,124.88,51,3,1,1,5,One-Time
17149,1,143.10000000000002,450,1,1,1,3,At-Risk
17150,6,1357.95,376,2,3,3,8,Other
17151,1,231.90000000000003,734,1,1,1,3,At-Risk
17152,4,2016.5,194,2,3,3,8,Other
17153,1,213.78,23,4,1,1,6,One-Time
17154,1,329.34,74,3,1,1,5,One-Time
17155,7,892.46,17,4,4,3,11,High-Value
17156,1,591.87,491,1,1,2,4,At-Risk
17157,19,5151.9,7,4,4,4,12,High-Value
17158,5,1980.0,31,3,3,3,9,High-Value
17159,5,2099.59,21,4,3,3,10,High-Value
17160,17,10209.16,30,3,4,4,11,High-Value
17161,1,856.01,443,1,1,2,4,At-Risk
17162,10,1715.46,28,3,4,3,10,High-Value
17163,4,699.78,21,4,3,2,9,High-Value
17164,7,2467.35,32,3,4,4,11,High-Value
17165,6,1794.32,283,2,3,3,8,Other
17166,2,206.34,38,3,2,1,6,Other
17167,3,867.11,379,1,3,3,7,At-Risk
17168,1,400.2,498,1,1,2,4,At-Risk
17169,3,1156.73,57,3,3,3,9,High-Value
17170,2,178.68,373,2,2,1,5,Other
17171,2,384.59000000000003,288,2,2,2,6,Other
17172,3,956.57,78,3,3,3,9,High-Value
17173,8,3766.6,4,4,4,4,12,High-Value
17174,1,59.9,217,2,1,1,4,One-Time
17175,4,1443.69,43,3,3,3,9,High-Value
17176,3,902.3199999999999,201,2,3,3,8,Other
17177,1,119.5,504,1,1,1,3,At-Risk
17178,1,432.96,730,1,1,2,4,At-Risk
17179,6,1507.26,177,2,3,3,8,Other
17180,11,2236.77,55,3,4,3,10,High-Value
17181,3,309.85,56,3,3,1,7,Loyal
17182,2,321.3,422,1,2,1,4,At-Risk
17183,6,3347.31,7,4,3,4,11,High-Value
17184,2,198.41,568,1,2,1,4,At-Risk
17185,3,229.46,591,1,3,1,5,At-Risk
17186,2,144.0,46,3,2,1,6,Other
17187,2,467.71,226,2,2,2,6,Other
17188,13,4592.93,10,4,4,4,12,High-Value
17189,5,953.63,105,2,3,3,8,Other
17190,7,1724.73,58,3,4,3,10,High-Value
17191,15,4310.34,27,3,4,4,11,High-Value
17192,1,75.28,535,1,1,1,3,At-Risk
17193,9,2310.04,35,3,4,4,11,High-Value
17194,2,776.66,360,2,2,2,6,Other
17195,1,562.98,654,1,1,2,4,At-Risk
17196,1,327.75,427,1,1,1,3,At-Risk
17197,1,1013.01,29,3,1,3,7,Other
17198,3,692.22,23,4,3,2,9,High-Value
17199,1,135.04000000000002,581,1,1,1,3,At-Risk
17200,4,356.71,386,1,3,2,6,At-Risk
17201,4,1132.6,53,3,3,3,9,High-Value
17202,1,160.65,420,1,1,1,3,At-Risk
17203,10,5564.09,35,3,4,4,11,High-Value
17204,9,5504.6900000000005,174,2,4,4,10,High-Value
17205,3,999.35,53,3,3,3,9,High-Value
17206,1,204.24,52,3,1,1,5,One-Time
17207,1,291.77,651,1,1,1,3,At-Risk
17208,1,111.15,395,1,1,1,3,At-Risk
17209,3,595.7,648,1,3,2,6,At-Risk
17210,1,251.72,392,1,1,1,3,At-Risk
17211,13,3773.35,26,3,4,4,11,High-Value
17212,3,794.41,252,2,3,2,7,Other
17213,13,4869.400000000001,39,3,4,4,11,High-Value
17214,6,1059.1200000000001,59,3,3,3,9,High-Value
17215,1,186.15,463,1,1,1,3,At-Risk
17216,1,63.6,553,1,1,1,3,At-Risk
17217,2,210.1,233,2,2,1,5,Other
17218,18,3889.39,3,4,4,4,12,High-Value
17219,2,259.13,31,3,2,1,6,Other
17220,21,4451.41,23,4,4,4,12,High-Value
17221,5,976.62,6,4,3,3,10,High-Value
17222,6,1563.6100000000001,64,3,3,3,9,High-Value
17223,3,523.04,309,2,3,2,7,Other
17224,1,100.86,500,1,1,1,3,At-Risk
17225,1,131.15,581,1,1,1,3,At-Risk
17226,3,895.47,308,2,3,3,8,Other
17227,12,1878.93,18,4,4,3,11,High-Value
17228,13,2820.03,15,4,4,4,12,High-Value
17229,2,318.76,95,2,2,1,5,Other
17230,18,9388.49,263,2,4,4,10,High-Value
17231,25,7064.8,11,4,4,4,12,High-Value
17232,2,417.77,2,4,2,2,8,Other
17233,3,560.86,34,3,3,2,8,Loyal
17234,1,149.89,182,2,1,1,4,One-Time
17235,8,1562.98,24,4,4,3,11,High-Value
17236,12,1929.26,12,4,4,3,11,High-Value
17237,4,994.13,10,4,3,3,10,High-Value
17238,32,7331.17,2,4,4,4,12,High-Value
17239,4,1189.45,312,2,3,3,8,Other
17240,1,130.60000000000002,595,1,1,1,3,At-Risk
17241,12,2736.64,384,1,4,4,9,High-Value
17242,5,2889.28,107,2,3,4,9,High-Value
17243,69,20184.68,0,4,4,4,12,High-Value
17244,5,1826.04,52,3,3,3,9,High-Value
17245,2,371.63,204,2,2,2,6,Other
17246,2,38.92,546,1,2,1,4,At-Risk
17247,1,280.09000000000003,14,4,1,1,6,One-Time
17248,2,500.54,119,2,2,2,6,Other
17249,1,68.03,428,1,1,1,3,At-Risk
17250,2,381.97,3,4,2,2,8,Other
17251,3,798.98,362,2,3,2,7,Other
17252,2,348.90999999999997,116,2,2,2,6,Other
17253,1,178.26,17,4,1,1,6,One-Time
17254,3,469.47999999999996,4,4,3,2,9,High-Value
17255,4,781.7,40,3,3,2,8,Loyal
17256,5,498.93,106,2,3,2,7,Other
17257,2,189.78,435,1,2,1,4,At-Risk
17258,2,417.3,396,1,2,2,5,At-Risk
17259,6,1452.39,147,2,3,3,8,Other
17260,1,120.95,410,1,1,1,3,At-Risk
17261,1,221.59,509,1,1,1,3,At-Risk
17262,11,2488.76,51,3,4,4,11,High-Value
17263,1,63.44,207,2,1,1,4,One-Time
17264,1,268.28,423,1,1,1,3,At-Risk
17265,2,550.01,138,2,2,2,6,Other
17266,5,501.72,1,4,3,2,9,High-Value
17267,2,317.2,126,2,2,1,5,Other
17268,11,1733.8899999999999,107,2,4,3,9,High-Value
17269,1,491.81,385,1,1,2,4,At-Risk
17270,2,601.4499999999999,468,1,2,2,5,At-Risk
17271,1,204.3,735,1,1,1,3,At-Risk
17272,4,2148.63,41,3,3,3,9,High-Value
17273,1,141.12,423,1,1,1,3,At-Risk
17274,2,573.22,34,3,2,2,7,Other
17275,1,114.10000000000001,382,1,1,1,3,At-Risk
17276,1,501.24,401,1,1,2,4,At-Risk
17277,2,1065.3500000000001,227,2,2,3,7,Other
17278,2,271.24,240,2,2,1,5,Other
17279,1,187.82999999999998,57,3,1,1,5,One-Time
17280,1,118.86,437,1,1,1,3,At-Risk
17281,6,797.85,373,2,3,2,7,Other
17282,5,2308.54,129,2,3,4,9,High-Value
17283,1,188.46,378,2,1,1,4,One-Time
17284,7,2558.6,59,3,4,4,11,High-Value
17285,2,400.44,627,1,2,2,5,At-Risk
17286,3,389.18,21,4,3,2,9,High-Value
17287,21,3826.86,25,3,4,4,11,High-Value
17288,11,2468.43,8,4,4,4,12,High-Value
17289,9,2041.8,31,3,4,3,10,High-Value
17290,8,1427.48,3,4,4,3,11,High-Value
17291,1,550.8000000000001,307,2,1,2,5,Other
17292,2,271.75,471,1,2,1,4,At-Risk
17293,17,3750.63,7,4,4,4,12,High-Value
17294,2,467.79,668,1,2,2,5,At-Risk
17295,3,547.0,28,3,3,2,8,Loyal
17296,1,338.13,729,1,1,1,3,At-Risk
17297,1,128.18,16,4,1,1,6,One-Time
17298,5,938.36,100,2,3,3,8,Other
17299,6,993.23,11,4,3,3,10,High-Value
17300,2,393.64,390,1,2,2,5,At-Risk
17301,2,294.39,20,4,2,1,7,Other
17302,5,1135.63,14,4,3,3,10,High-Value
17303,1,250.04,360,2,1,1,4,One-Time
17304,1,111.5,533,1,1,1,3,At-Risk
17305,1,2135.46,648,1,1,3,5,At-Risk
17306,21,9782.35,10,4,4,4,12,High-Value
17307,11,3999.89,394,1,4,4,9,High-Value
17308,2,4511.76,392,1,2,4,7,At-Risk
17309,3,320.39,94,3,3,1,7,Loyal
17310,2,1025.1,386,1,2,3,6,At-Risk
17311,6,3566.56,77,3,3,4,10,High-Value
17312,3,644.3,138,2,3,2,7,Other
17313,1,2328.84,30,3,1,4,8,Other
17314,17,4904.43,24,4,4,4,12,High-Value
17315,41,9559.5,1,4,4,4,12,High-Value
17316,1,124.45,419,1,1,1,3,At-Risk
17317,3,2600.34,45,3,3,4,10,High-Value
17318,1,157.33,724,1,1,1,3,At-Risk
17319,1,29.1,668,1,1,1,3,At-Risk
17320,6,2444.85,99,2,3,4,9,High-Value
17321,6,1665.21,7,4,3,3,10,High-Value
17322,5,922.59,375,2,3,3,8,Other
17323,12,1547.64,14,4,4,3,11,High-Value
17324,12,2171.07,17,4,4,3,11,High-Value
17325,3,609.5699999999999,279,2,3,2,7,Other
17326,2,312.35,407,1,2,1,4,At-Risk
17327,2,152.35,409,1,2,1,4,At-Risk
17328,1,104.7,672,1,1,1,3,At-Risk
17329,5,998.53,13,4,3,3,10,High-Value
17330,4,423.8,22,4,3,2,9,High-Value
17331,1,175.2,123,2,1,1,4,One-Time
17332,5,827.77,527,1,3,2,6,At-Risk
17333,1,494.25,85,3,1,2,6,Other
17334,3,635.15,301,2,3,2,7,Other
17335,2,497.04,383,1,2,2,5,At-Risk
17336,1,81.12,471,1,1,1,3,At-Risk
17337,4,1979.61,150,2,3,3,8,Other
17338,17,11880.54,16,4,4,4,12,High-Value
17339,3,302.36,93,3,3,1,7,Loyal
17340,18,19617.95,29,3,4,4,11,High-Value
17341,5,1272.21,156,2,3,3,8,Other
17342,4,1227.54,379,1,3,3,7,At-Risk
17343,6,1259.94,354,2,3,3,8,Other
17344,2,457.36,45,3,2,2,7,Other
17345,10,1586.63,14,4,4,3,11,High-Value
17346,26,4991.41,3,4,4,4,12,High-Value
17347,1,228.96,85,3,1,1,5,One-Time
17348,9,2430.99,14,4,4,4,12,High-Value
17349,5,772.41,178,2,3,2,7,Other
17350,7,1893.701,7,4,4,3,11,High-Value
17351,12,1964.38,35,3,4,3,10,High-Value
17352,1,36.25,695,1,1,1,3,At-Risk
17353,4,3242.0,128,2,3,4,9,High-Value
17354,4,3133.96,50,3,3,4,10,High-Value
17355,1,273.31,385,1,1,1,3,At-Risk
17356,5,946.47,311,2,3,3,8,Other
17357,2,384.39,23,4,2,2,8,Other
17358,5,861.01,302,2,3,3,8,Other
17359,2,284.46,10,4,2,1,7,Other
17360,6,1200.51,16,4,3,3,10,High-Value
17361,5,871.79,48,3,3,3,9,High-Value
17362,7,1024.04,238,2,4,3,9,High-Value
17363,3,920.46,394,1,3,3,7,At-Risk
17364,28,11972.92,0,4,4,4,12,High-Value
17365,15,8179.45,12,4,4,4,12,High-Value
17366,2,1077.24,431,1,2,3,6,At-Risk
17367,1,167.55,237,2,1,1,4,One-Time
17368,14,2758.29,22,4,4,4,12,High-Value
17369,1,979.2,455,1,1,3,5,At-Risk
17370,4,446.18,72,3,3,2,8,Loyal
17371,6,651.37,16,4,3,2,9,High-Value
17372,27,4316.46,40,3,4,4,11,High-Value
17373,7,1167.5,39,3,4,3,10,High-Value
17374,3,727.11,218,2,3,2,7,Other
17375,4,660.55,198,2,3,2,7,Other
17376,4,453.64,70,3,3,2,8,Loyal
17377,78,17639.23,23,4,4,4,12,High-Value
17378,1,10.95,373,2,1,1,4,One-Time
17379,1,389.72,10,4,1,2,7,Other
17380,3,645.0,433,1,3,2,6,At-Risk
17381,38,36398.65,8,4,4,4,12,High-Value
17382,8,902.28,64,3,4,3,10,High-Value
17383,2,304.09000000000003,3,4,2,1,7,Other
17384,3,507.55,18,4,3,2,9,High-Value
17385,1,256.11,14,4,1,1,6,One-Time
17386,7,2812.77,7,4,4,4,12,High-Value
17387,2,746.81,19,4,2,2,8,Other
17388,11,2675.37,77,3,4,4,11,High-Value
17389,61,57215.33,0,4,4,4,12,High-Value
17390,1,149.29999999999998,420,1,1,1,3,At-Risk
17391,2,508.8,163,2,2,2,6,Other
17392,3,579.92,306,2,3,2,7,Other
17393,2,381.15,410,1,2,2,5,At-Risk
17394,1,203.86999999999998,218,2,1,1,4,One-Time
17395,1,97.5,507,1,1,1,3,At-Risk
17396,13,8391.6,38,3,4,4,11,High-Value
17397,3,1198.28,21,4,3,3,10,High-Value
17398,3,653.38,114,2,3,2,7,Other
17400,8,4623.28,125,2,4,4,10,High-Value
17401,1,114.85,540,1,1,1,3,At-Risk
17402,22,4600.5599999999995,4,4,4,4,12,High-Value
17403,2,382.87,35,3,2,2,7,Other
17404,21,47638.12,3,4,4,4,12,High-Value
17405,3,1031.41,0,4,3,3,10,High-Value
17406,13,4186.95,332,2,4,4,10,High-Value
17407,1,552.9,411,1,1,2,4,At-Risk
17408,3,316.09000000000003,162,2,3,1,6,Other
17409,10,7793.51,184,2,4,4,10,High-Value
17410,5,1214.72,15,4,3,3,10,High-Value
17411,5,1425.38,11,4,3,3,10,High-Value
17412,16,4220.22,2,4,4,4,12,High-Value
17413,2,560.14,404,1,2,2,5,At-Risk
17414,6,2249.52,43,3,3,4,10,High-Value
17415,1,507.84,79,3,1,2,6,Other
17416,22,17298.45,29,3,4,4,11,High-Value
17417,1,164.18,548,1,1,1,3,At-Risk
17418,3,670.0600000000001,41,3,3,2,8,Loyal
17419,18,6126.25,10,4,4,4,12,High-Value
17420,6,953.58,49,3,3,3,9,High-Value
17421,3,1059.41,385,1,3,3,7,At-Risk
17422,11,3594.76,15,4,4,4,12,High-Value
17423,3,1118.95,45,3,3,3,9,High-Value
17425,2,759.17,18,4,2,2,8,Other
17426,13,8077.77,7,4,4,4,12,High-Value
17427,1,100.8,71,3,1,1,5,One-Time
17428,45,31466.760000000002,0,4,4,4,12,High-Value
17429,5,1357.46,127,2,3,3,8,Other
17430,4,622.57,32,3,3,2,8,Loyal
17431,1,403.3,312,2,1,2,5,Other
17432,9,1728.99,17,4,4,3,11,High-Value
17433,2,569.96,87,3,2,2,7,Other
17434,7,2373.82,1,4,4,4,12,High-Value
17435,1,331.35,410,1,1,1,3,At-Risk
17436,5,534.0600000000001,1,4,3,2,9,High-Value
17437,1,369.68,529,1,1,2,4,At-Risk
17438,5,1422.77,253,2,3,3,8,Other
17439,1,325.74,655,1,1,1,3,At-Risk
17440,4,323.58,156,2,3,1,6,Other
17441,1,293.35,731,1,1,1,3,At-Risk
17442,15,4620.3,36,3,4,4,11,High-Value
17443,1,534.24,219,2,1,2,5,Other
17444,2,2389.1,151,2,2,4,8,Other
17446,2,120.89999999999999,176,2,2,1,5,Other
17447,2,541.53,39,3,2,2,7,Other
17448,41,14448.67,528,1,4,4,9,High-Value
17449,13,4865.15,1,4,4,4,12,High-Value
17450,51,244784.25,7,4,4,4,12,High-Value
17451,7,1721.4,0,4,4,3,11,High-Value
17453,2,486.72,17,4,2,2,8,Other
17454,10,1547.94,191,2,4,3,9,High-Value
17455,1,131.7,203,2,1,1,4,One-Time
17456,2,975.5600000000001,364,2,2,3,7,Other
17457,14,5984.81,126,2,4,4,10,High-Value
17458,2,529.58,14,4,2,2,8,Other
17459,2,657.3,42,3,2,2,7,Other
17460,16,2157.9700000000003,93,3,4,3,10,High-Value
17461,3,735.82,22,4,3,2,9,High-Value
17462,2,675.69,59,3,2,2,7,Other
17463,7,2535.26,15,4,4,4,12,High-Value
17464,3,907.14,157,2,3,3,8,Other
17465,7,2542.79,425,1,4,4,9,High-Value
17466,2,763.28,9,4,2,2,8,Other
17467,1,102.6,394,1,1,1,3,At-Risk
17468,3,194.8,9,4,3,1,8,Loyal
17469,17,5051.25,15,4,4,4,12,High-Value
17470,11,2626.47,44,3,4,4,11,High-Value
17471,1,321.65000000000003,474,1,1,1,3,At-Risk
17472,4,922.35,190,2,3,3,8,Other
17473,2,607.0,408,1,2,2,5,At-Risk
17474,1,1047.0,599,1,1,3,5,At-Risk
17475,1,194.37,78,3,1,1,5,One-Time
17476,2,489.86,395,1,2,2,5,At-Risk
17477,2,1144.3,612,1,2,3,6,At-Risk
17478,2,1272.8000000000002,407,1,2,3,6,At-Risk
17479,1,389.26,632,1,1,2,4,At-Risk
17480,2,882.23,77,3,2,3,8,Other
17481,4,1255.59,3,4,3,3,10,High-Value
17482,2,775.64,486,1,2,2,5,At-Risk
17483,4,591.73,64,3,3,2,8,Loyal
17484,2,209.57,575,1,2,1,4,At-Risk
17486,1,396.87,260,2,1,2,5,Other
17487,1,160.55,727,1,1,1,3,At-Risk
17488,1,336.5,640,1,1,1,3,At-Risk
17489,2,376.64,58,3,2,2,7,Other
17490,9,2750.5,0,4,4,4,12,High-Value
17491,17,5653.67,0,4,4,4,12,High-Value
17492,3,1122.42,247,2,3,3,8,Other
17493,1,100.91,384,1,1,1,3,At-Risk
17494,1,54.7,501,1,1,1,3,At-Risk
17495,3,806.72,7,4,3,2,9,High-Value
17496,4,1412.89,358,2,3,3,8,Other
17497,2,287.25,389,1,2,1,4,At-Risk
17498,1,272.21999999999997,75,3,1,1,5,One-Time
17499,2,1341.3899999999999,289,2,2,3,7,Other
17500,3,1138.0,16,4,3,3,10,High-Value
17501,2,288.6,220,2,2,1,5,Other
17502,4,689.1,8,4,3,2,9,High-Value
17503,2,558.96,2,4,2,2,8,Other
17504,18,9490.17,205,2,4,4,10,High-Value
17505,5,2435.48,161,2,3,4,9,High-Value
17506,1,302.2,75,3,1,1,5,One-Time
17507,2,605.58,261,2,2,2,6,Other
17508,8,4579.23,280,2,4,4,10,High-Value
17509,8,6083.64,57,3,4,4,11,High-Value
17510,2,514.56,24,4,2,2,8,Other
17511,60,172132.87,2,4,4,4,12,High-Value
17512,18,5467.820000000001,28,3,4,4,11,High-Value
17513,3,1158.8,71,3,3,3,9,High-Value
17514,2,522.0,127,2,2,2,6,Other
17515,9,1602.51,30,3,4,3,10,High-Value
17516,6,947.5,14,4,3,3,10,High-Value
17517,1,153.94,308,2,1,1,4,One-Time
17518,2,329.42,425,1,2,1,4,At-Risk
17519,15,4774.17,16,4,4,4,12,High-Value
17520,1,546.81,53,3,1,2,6,Other
17521,5,1278.06,29,3,3,3,9,High-Value
17522,5,1066.15,1,4,3,3,10,High-Value
17523,4,652.74,10,4,3,2,9,High-Value
17524,3,539.14,360,2,3,2,7,Other
17525,3,1161.9,359,2,3,3,8,Other
17526,12,3939.24,4,4,4,4,12,High-Value
17527,4,939.37,53,3,3,3,9,High-Value
17528,8,3628.5,0,4,4,4,12,High-Value
17529,2,1240.25,609,1,2,3,6,At-Risk
17530,12,2787.1,0,4,4,4,12,High-Value
17531,3,1266.82,189,2,3,3,8,Other
17532,1,65.34,385,1,1,1,3,At-Risk
17533,1,34.8,434,1,1,1,3,At-Risk
17534,5,1668.83,53,3,3,3,9,High-Value
17535,1,164.4,279,2,1,1,4,One-Time
17536,3,364.83,176,2,3,2,7,Other
17537,2,887.6700000000001,29,3,2,3,8,Other
17538,1,98.42,25,3,1,1,5,One-Time
17539,3,1161.84,627,1,3,3,7,At-Risk
17540,6,1590.6000000000001,24,4,3,3,10,High-Value
17541,1,119.86,509,1,1,1,3,At-Risk
17542,3,340.85,269,2,3,2,7,Other
17543,1,120.05,549,1,1,1,3,At-Risk
17544,3,944.82,389,1,3,3,7,At-Risk
17545,6,1409.86,42,3,3,3,9,High-Value
17547,2,727.85,375,2,2,2,6,Other
17548,4,731.26,233,2,3,2,7,Other
17549,2,148.86,23,4,2,1,7,Other
17550,9,2506.64,196,2,4,4,10,High-Value
17551,1,290.34,358,2,1,1,4,One-Time
17552,12,2786.77,59,3,4,4,11,High-Value
17553,4,3757.6,129,2,3,4,9,High-Value
17554,5,1952.45,0,4,3,3,10,High-Value
17555,5,1045.74,19,4,3,3,10,High-Value
17556,2,300.67,205,2,2,1,5,Other
17557,4,575.46,13,4,3,2,9,High-Value
17558,1,259.17,392,1,1,1,3,At-Risk
17559,1,167.62,512,1,1,1,3,At-Risk
17560,8,1895.8,94,3,4,3,10,High-Value
17561,4,703.02,18,4,3,2,9,High-Value
17562,7,1122.38,13,4,4,3,11,High-Value
17563,2,392.38,577,1,2,2,5,At-Risk
17564,3,454.01,23,4,3,2,9,High-Value
17565,1,131.83,586,1,1,1,3,At-Risk
17566,2,869.77,7,4,2,3,9,High-Value
17567,9,4838.08,6,4,4,4,12,High-Value
17568,1,374.45,632,1,1,2,4,At-Risk
17569,1,344.14,331,2,1,2,5,Other
17571,5,1629.66,49,3,3,3,9,High-Value
17572,10,652.21,70,3,4,2,9,High-Value
17573,3,380.6,28,3,3,2,8,Loyal
17574,1,185.65,242,2,1,1,4,One-Time
17575,1,171.7,666,1,1,1,3,At-Risk
17576,41,8705.6,7,4,4,4,12,High-Value
17577,2,348.75,644,1,2,2,5,At-Risk
17578,7,1047.33,217,2,4,3,9,High-Value
17579,4,753.28,4,4,3,2,9,High-Value
17580,5,538.07,252,2,3,2,7,Other
17581,43,17951.170000000002,0,4,4,4,12,High-Value
17582,5,1446.95,235,2,3,3,8,Other
17583,1,135.95,559,1,1,1,3,At-Risk
17584,6,5309.42,6,4,3,4,11,High-Value
17585,7,2064.71,108,2,4,3,9,High-Value
17586,1,167.4,618,1,1,1,3,At-Risk
17587,1,173.76,627,1,1,1,3,At-Risk
17588,7,2939.55,99,2,4,4,10,High-Value
17589,18,13806.27,59,3,4,4,11,High-Value
17590,3,1466.77,1,4,3,3,10,High-Value
17591,8,2339.32,72,3,4,4,11,High-Value
17592,1,148.3,738,1,1,1,3,At-Risk
17593,11,8092.32,3,4,4,4,12,High-Value
17594,4,2497.88,84,3,3,4,10,High-Value
17595,2,386.69,11,4,2,2,8,Other
17596,13,4491.46,22,4,4,4,12,High-Value
17597,5,3484.09,213,2,3,4,9,High-Value
17598,1,409.98,380,1,1,2,4,At-Risk
17599,1,52.05,477,1,1,1,3,At-Risk
17600,1,161.67000000000002,17,4,1,1,6,One-Time
17601,2,412.65999999999997,238,2,2,2,6,Other
17602,14,7354.43,1,4,4,4,12,High-Value
17603,4,1788.38,77,3,3,3,9,High-Value
17604,6,942.38,216,2,3,3,8,Other
17605,1,160.75,589,1,1,1,3,At-Risk
17606,1,87.30000000000001,736,1,1,1,3,At-Risk
17607,1,333.81,375,2,1,1,4,One-Time
17608,4,488.06,32,3,3,2,8,Loyal
17609,11,1875.36,40,3,4,3,10,High-Value
17610,5,1511.94,539,1,3,3,7,At-Risk
17611,28,8287.53,6,4,4,4,12,High-Value
17612,18,5394.86,52,3,4,4,11,High-Value
17613,14,4544.55,22,4,4,4,12,High-Value
17614,1,386.32,56,3,1,2,6,Other
17615,6,721.8000000000001,129,2,3,2,7,Other
17616,4,734.4,173,2,3,2,7,Other
17617,1,385.19,558,1,1,2,4,At-Risk
17618,11,4001.64,5,4,4,4,12,High-Value
17619,1,214.37,311,2,1,1,4,One-Time
17620,1,81.44,59,3,1,1,5,One-Time
17621,6,3175.12,20,4,3,4,11,High-Value
17622,2,1130.21,597,1,2,3,6,At-Risk
17623,7,2365.77,32,3,4,4,11,High-Value
17624,4,1568.63,14,4,3,3,10,High-Value
17625,8,5978.9,17,4,4,4,12,High-Value
17626,1,254.0,602,1,1,1,3,At-Risk
17627,1,296.36,478,1,1,1,3,At-Risk
17628,1,75.75,80,3,1,1,5,One-Time
17629,10,2455.52,5,4,4,4,12,High-Value
17630,2,503.6,169,2,2,2,6,Other
17631,7,998.49,1,4,4,3,11,High-Value
17633,7,2057.39,30,3,4,3,10,High-Value
17634,9,2358.59,35,3,4,4,11,High-Value
17635,3,1265.58,423,1,3,3,7,At-Risk
17636,1,285.56,18,4,1,1,6,One-Time
17637,2,547.0600000000001,30,3,2,2,7,Other
17638,2,842.4000000000001,646,1,2,2,5,At-Risk
17639,6,615.17,275,2,3,2,7,Other
17640,6,3168.94,86,3,3,4,10,High-Value
17642,5,1824.49,119,2,3,3,8,Other
17643,2,439.7,372,2,2,2,6,Other
17644,20,6028.6,0,4,4,4,12,High-Value
17646,12,3898.79,218,2,4,4,10,High-Value
17647,3,331.65999999999997,64,3,3,1,7,Loyal
17648,5,2216.37,60,3,3,3,9,High-Value
17649,3,1578.89,137,2,3,3,8,Other
17650,1,166.07999999999998,20,4,1,1,6,One-Time
17651,16,5703.52,11,4,4,4,12,High-Value
17652,12,4867.72,24,4,4,4,12,High-Value
17653,4,1207.56,36,3,3,3,9,High-Value
17654,1,117.55,276,2,1,1,4,One-Time
17655,9,2976.38,10,4,4,4,12,High-Value
17656,5,1674.69,72,3,3,3,9,High-Value
17657,1,126.0,429,1,1,1,3,At-Risk
17658,2,595.42,25,3,2,2,7,Other
17659,14,3586.9900000000002,16,4,4,4,12,High-Value
17660,2,342.21999999999997,140,2,2,2,6,Other
17662,2,412.92,661,1,2,2,5,At-Risk
17663,17,5175.83,25,3,4,4,11,High-Value
17664,4,1166.23,18,4,3,3,10,High-Value
17665,1,563.1,492,1,1,2,4,At-Risk
17666,5,2047.8,3,4,3,3,10,High-Value
17667,9,3950.7,65,3,4,4,11,High-Value
17668,2,347.75,0,4,2,2,8,Other
17669,10,6142.35,42,3,4,4,11,High-Value
17670,1,205.7,227,2,1,1,4,One-Time
17671,5,2009.16,15,4,3,3,10,High-Value
17672,6,5663.74,49,3,3,4,10,High-Value
17673,13,4173.88,1,4,4,4,12,High-Value
17674,2,551.04,73,3,2,2,7,Other
17675,70,37642.48,0,4,4,4,12,High-Value
17676,10,2448.64,3,4,4,4,12,High-Value
17677,54,35058.46,1,4,4,4,12,High-Value
17678,2,599.76,263,2,2,2,6,Other
17679,7,3577.61,52,3,4,4,11,High-Value
17680,3,497.45000000000005,23,4,3,2,9,High-Value
17681,5,731.2,596,1,3,2,6,At-Risk
17682,11,4065.28,9,4,4,4,12,High-Value
17683,3,819.01,385,1,3,2,6,At-Risk
17684,1,239.41,43,3,1,1,5,One-Time
17685,12,5454.95,16,4,4,4,12,High-Value
17686,9,8296.81,6,4,4,4,12,High-Value
17687,1,432.68,420,1,1,2,4,At-Risk
17688,1,304.2,393,1,1,1,3,At-Risk
17689,2,317.08,387,1,2,1,4,At-Risk
17690,20,6963.8,29,3,4,4,11,High-Value
17691,4,637.55,357,2,3,2,7,Other
17692,12,2960.44,126,2,4,4,10,High-Value
17693,1,200.47,136,2,1,1,4,One-Time
17694,3,1695.97,141,2,3,3,8,Other
17695,5,1746.04,131,2,3,3,8,Other
17696,27,7679.59,37,3,4,4,11,High-Value
17697,1,338.95000000000005,235,2,1,1,4,One-Time
17698,1,154.95,260,2,1,1,4,One-Time
17699,2,442.0,476,1,2,2,5,At-Risk
17700,14,6679.97,16,4,4,4,12,High-Value
17701,1,417.95,252,2,1,2,5,Other
17702,6,3144.04,29,3,3,4,10,High-Value
17703,4,1094.84,34,3,3,3,9,High-Value
17704,2,885.19,168,2,2,3,7,Other
17705,11,2083.9,2,4,4,3,11,High-Value
17706,31,20272.15,3,4,4,4,12,High-Value
17707,8,609.3,184,2,4,2,8,Other
17708,4,884.1800000000001,187,2,3,3,8,Other
17709,5,671.01,169,2,3,2,7,Other
17710,1,293.5,423,1,1,1,3,At-Risk
17711,2,385.1,10,4,2,2,8,Other
17712,1,522.91,44,3,1,2,6,Other
17713,4,1198.09,381,1,3,3,7,At-Risk
17714,5,1410.18,320,2,3,3,8,Other
17715,2,489.59999999999997,200,2,2,2,6,Other
17716,24,15956.970000000001,22,4,4,4,12,High-Value
17717,1,376.92,420,1,1,2,4,At-Risk
17718,2,439.18,231,2,2,2,6,Other
17719,15,5396.04,37,3,4,4,11,High-Value
17720,10,2666.91,25,3,4,4,11,High-Value
17721,1,307.21000000000004,658,1,1,1,3,At-Risk
17722,5,3520.2200000000003,95,2,3,4,9,High-Value
17723,7,3378.4000000000005,126,2,4,4,10,High-Value
17724,3,1033.0,70,3,3,3,9,High-Value
17725,11,3439.08,15,4,4,4,12,High-Value
17726,7,1092.06,394,1,4,3,8,At-Risk
17727,1,1060.25,14,4,1,3,8,Other
17728,5,4238.76,3,4,3,4,11,High-Value
17729,1,438.65000000000003,595,1,1,2,4,At-Risk
17730,20,7773.8,2,4,4,4,12,High-Value
17731,6,1708.99,78,3,3,3,9,High-Value
17732,8,2166.42,372,2,4,3,9,High-Value
17733,2,692.19,38,3,2,2,7,Other
17734,6,1442.32,53,3,3,3,9,High-Value
17735,26,16790.33,1,4,4,4,12,High-Value
17736,3,377.44,8,4,3,2,9,High-Value
17737,2,168.24,8,4,2,1,7,Other
17738,13,4183.56,18,4,4,4,12,High-Value
17739,18,7730.59,11,4,4,4,12,High-Value
17740,6,426.90000000000003,388,1,3,2,6,At-Risk
17741,2,101.1,406,1,2,1,4,At-Risk
17742,11,2098.48,112,2,4,3,9,High-Value
17743,1,229.2,447,1,1,1,3,At-Risk
17744,7,2649.14,3,4,4,4,12,High-Value
17745,2,600.34,477,1,2,2,5,At-Risk
17746,4,904.1800000000001,239,2,3,3,8,Other
17747,1,71.4,112,2,1,1,4,One-Time
17748,1,358.15,526,1,1,2,4,At-Risk
17749,3,1026.18,177,2,3,3,8,Other
17750,9,1694.16,4,4,4,3,11,High-Value
17751,1,157.85999999999999,420,1,1,1,3,At-Risk
17752,1,80.64,358,2,1,1,4,One-Time
17753,4,382.06,463,1,3,2,6,At-Risk
17754,13,4451.22,0,4,4,4,12,High-Value
17756,3,728.75,375,2,3,2,7,Other
17757,56,9070.1,0,4,4,4,12,High-Value
17758,12,4964.03,18,4,4,4,12,High-Value
17759,5,1260.63,16,4,3,3,10,High-Value
17760,6,746.39,21,4,3,2,9,High-Value
17761,1,712.78,32,3,1,2,6,Other
17762,1,129.75,455,1,1,1,3,At-Risk
17763,4,86.15,262,2,3,1,6,Other
17764,5,1513.57,50,3,3,3,9,High-Value
17765,4,524.0,158,2,3,2,7,Other
17766,2,299.61,380,1,2,1,4,At-Risk
17767,2,413.05,14,4,2,2,8,Other
17768,7,3292.73,7,4,4,4,12,High-Value
17769,17,7053.38,12,4,4,4,12,High-Value
17770,5,1143.27,198,2,3,3,8,Other
17771,4,386.93,56,3,3,2,8,Loyal
17772,3,360.75,10,4,3,2,9,High-Value
17773,2,575.37,513,1,2,2,5,At-Risk
17774,9,3272.83,96,2,4,4,10,High-Value
17775,1,56.4,254,2,1,1,4,One-Time
17776,2,329.3,386,1,2,1,4,At-Risk
17777,3,647.56,24,4,3,2,9,High-Value
17778,1,197.70000000000002,661,1,1,1,3,At-Risk
17779,3,650.32,20,4,3,2,9,High-Value
17780,3,346.56,666,1,3,2,6,At-Risk
17781,2,188.02,158,2,2,1,5,Other
17782,2,679.02,382,1,2,2,5,At-Risk
17783,3,376.96,71,3,3,2,8,Loyal
17784,1,112.86,549,1,1,1,3,At-Risk
17785,3,403.38,52,3,3,2,8,Loyal
17786,2,266.85,84,3,2,1,6,Other
17787,4,1817.54,152,2,3,3,8,Other
17788,2,1112.95,73,3,2,3,8,Other
17789,2,397.15,280,2,2,2,6,Other
17790,20,2779.41,26,3,4,4,11,High-Value
17791,1,106.1,29,3,1,1,5,One-Time
17792,2,368.35,466,1,2,2,5,At-Risk
17793,1,300.34000000000003,24,4,1,1,6,One-Time
17794,2,147.3,686,1,2,1,4,At-Risk
17795,2,342.83,179,2,2,2,6,Other
17796,7,1236.39,39,3,4,3,10,High-Value
17797,8,1971.8700000000001,21,4,4,3,11,High-Value
17798,1,172.17000000000002,581,1,1,1,3,At-Risk
17799,20,6246.93,21,4,4,4,12,High-Value
17800,9,1186.21,36,3,4,3,10,High-Value
17801,3,770.03,450,1,3,2,6,At-Risk
17802,10,4946.22,81,3,4,4,11,High-Value
17803,1,184.66,391,1,1,1,3,At-Risk
17804,3,383.78000000000003,375,2,3,2,7,Other
17805,2,927.03,73,3,2,3,8,Other
17806,1,546.04,10,4,1,2,7,Other
17807,3,437.87,394,1,3,2,6,At-Risk
17808,4,262.64,548,1,3,1,5,At-Risk
17809,20,10085.89,15,4,4,4,12,High-Value
17810,2,343.21,668,1,2,2,5,At-Risk
17811,47,9513.1,3,4,4,4,12,High-Value
17812,7,911.99,12,4,4,3,11,High-Value
17813,5,1698.07,13,4,3,3,10,High-Value
17814,2,1609.37,374,2,2,3,7,Other
17815,1,591.96,392,1,1,2,4,At-Risk
17816,6,96.11,36,3,3,1,7,Loyal
17817,6,788.15,3,4,3,2,9,High-Value
17818,1,124.78,737,1,1,1,3,At-Risk
17819,12,6021.05,71,3,4,4,11,High-Value
17820,1,180.60999999999999,373,2,1,1,4,One-Time
17821,1,334.62,405,1,1,1,3,At-Risk
17822,5,2154.08,419,1,3,3,7,At-Risk
17823,2,449.25,420,1,2,2,5,At-Risk
17824,1,298.4,50,3,1,1,5,One-Time
17825,4,701.96,598,1,3,2,6,At-Risk
17826,1,133.34,373,2,1,1,4,One-Time
17827,6,2376.17,4,4,3,4,11,High-Value
17828,4,1165.09,22,4,3,3,10,High-Value
17829,5,4756.74,298,2,3,4,9,High-Value
17830,3,398.7,1,4,3,2,9,High-Value
17831,1,35.400000000000006,32,3,1,1,5,One-Time
17832,1,155.37,49,3,1,1,5,One-Time
17833,1,338.46000000000004,722,1,1,1,3,At-Risk
17834,2,689.6700000000001,414,1,2,2,5,At-Risk
17835,3,342.24,2,4,3,2,9,High-Value
17836,1,109.83,46,3,1,1,5,One-Time
17837,8,1535.33,41,3,4,3,10,High-Value
17838,13,5604.64,26,3,4,4,11,High-Value
17839,1,318.15,41,3,1,1,5,One-Time
17840,1,175.9,443,1,1,1,3,At-Risk
17841,211,68519.95,1,4,4,4,12,High-Value
17842,1,430.69,601,1,1,2,4,At-Risk
17843,2,312.65,302,2,2,1,5,Other
17844,1,51.56,106,2,1,1,4,One-Time
17845,4,596.09,554,1,3,2,6,At-Risk
17847,2,125.74000000000001,515,1,2,1,4,At-Risk
17848,30,3538.46,80,3,4,4,11,High-Value
17849,8,1063.76,217,2,4,3,9,High-Value
17850,155,51208.87,371,2,4,4,10,High-Value
17851,6,1552.35,421,1,3,3,7,At-Risk
17852,5,657.8100000000001,11,4,3,2,9,High-Value
17853,3,1596.29,406,1,3,3,7,At-Risk
17854,6,1068.5,184,2,3,3,8,Other
17855,1,208.97,372,2,1,1,4,One-Time
17856,4,1418.03,1,4,3,3,10,High-Value
17857,23,25769.54,3,4,4,4,12,High-Value
17858,30,12518.65,5,4,4,4,12,High-Value
17859,1,141.92,304,2,1,1,4,One-Time
17860,4,717.39,368,2,3,2,7,Other
17861,18,5088.29,2,4,4,4,12,High-Value
17862,4,1254.89,323,2,3,3,8,Other
17863,12,5360.4800000000005,58,3,4,4,11,High-Value
17864,5,876.57,12,4,3,3,10,High-Value
17865,46,26310.09,30,3,4,4,11,High-Value
17866,3,1134.95,142,2,3,3,8,Other
17867,14,1560.72,29,3,4,3,10,High-Value
17868,1,227.15,385,1,1,1,3,At-Risk
17869,7,813.64,106,2,4,2,8,Other
17870,13,2753.29,1,4,4,4,12,High-Value
17871,5,1068.95,204,2,3,3,8,Other
17872,1,235.87,381,1,1,1,3,At-Risk
17873,18,6135.95,79,3,4,4,11,High-Value
17874,6,683.46,184,2,3,2,7,Other
17875,1,167.1,687,1,2,1,4,At-Risk
17876,3,3424.02,399,1,3,4,8,At-Risk
17877,1,237.61,169,2,2,1,5,Other
17878,3,1378.93,43,3,3,3,9,High-Value
17879,1,178.52,173,2,2,1,5,Other
17880,3,824.9200000000001,364,2,3,2,7,Other
17881,1,133.35,303,2,2,1,5,Other
17882,2,291.56,378,2,2,1,5,Other
17883,7,988.42,2,4,4,3,11,High-Value
17884,20,2693.47,3,4,4,4,12,High-Value
17885,1,156.34,11,4,2,1,7,Other
17886,6,1572.55,31,3,3,3,9,High-Value
17887,1,111.35000000000001,128,2,2,1,5,Other
17888,25,1807.44,20,4,4,3,11,High-Value
17889,7,746.42,211,2,4,2,8,Other
17890,2,586.89,322,2,2,2,6,Other
17891,1,203.85999999999999,161,2,2,1,5,Other
17892,3,244.1,55,3,3,1,7,Loyal
17893,1,107.21000000000001,224,2,2,1,5,Other
17894,18,2304.16,71,3,4,4,11,High-Value
17895,1,95.45,43,3,2,1,6,Other
17896,1,256.32,22,4,2,1,7,Other
17897,9,2053.04,172,2,4,3,9,High-Value
17898,4,299.18,84,3,3,1,7,Loyal
17899,1,154.55,158,2,2,1,5,Other
17900,2,112.19999999999999,189,2,2,1,5,Other
17901,3,260.08,28,3,3,1,7,Loyal
17902,1,216.4,546,1,2,1,4,At-Risk
17903,1,381.09000000000003,393,1,2,2,5,At-Risk
17904,1,181.07,20,4,2,1,7,Other
17905,13,2168.37,70,3,4,3,10,High-Value
17906,1,72.9,246,2,2,1,5,Other
17907,1,291.76,640,1,2,1,4,At-Risk
17908,5,1142.47,373,2,3,3,8,Other
17909,1,110.05,736,1,2,1,4,At-Risk
17910,1,261.7,725,1,2,1,4,At-Risk
17911,1,366.23,8,4,2,2,8,Other
17912,6,371.6,309,2,3,2,7,Other
17913,14,3425.09,58,3,4,4,11,High-Value
17914,1,329.36,3,4,2,1,7,Other
17915,1,225.78,550,1,2,1,4,At-Risk
17916,2,43.87,628,1,2,1,4,At-Risk
17917,3,335.03,44,3,3,1,7,Loyal
17918,3,388.44,500,1,3,2,6,At-Risk
17919,2,1840.32,87,3,2,3,8,Other
17920,54,23569.88,3,4,4,4,12,High-Value
17921,10,2394.36,63,3,4,4,11,High-Value
17922,1,170.4,542,1,2,1,4,At-Risk
17923,3,497.0,281,2,3,2,7,Other
17924,8,3257.7000000000003,11,4,4,4,12,High-Value
17925,1,244.08,372,2,2,1,5,Other
17926,5,1035.49,132,2,3,3,8,Other
17927,1,294.0,721,1,2,1,4,At-Risk
17928,3,313.16,44,3,3,1,7,Loyal
17929,12,3082.1,10,4,4,4,12,High-Value
17930,13,4275.22,35,3,4,4,11,High-Value
17931,14,3402.2400000000002,133,2,4,4,10,High-Value
17932,3,1331.57,28,3,3,3,9,High-Value
17933,1,105.99,631,1,2,1,4,At-Risk
17934,3,1049.15,51,3,3,3,9,High-Value
17935,7,683.24,137,2,4,2,8,Other
17936,1,380.13,4,4,2,2,8,Other
17937,7,4301.22,8,4,4,4,12,High-Value
17938,1,144.29,419,1,2,1,4,At-Risk
17939,1,99.14,159,2,2,1,5,Other
17940,14,28389.58,48,3,4,4,11,High-Value
17941,4,1433.28,130,2,3,3,8,Other
17942,1,77.50000000000001,7,4,2,1,7,Other
17944,1,74.99,422,1,2,1,4,At-Risk
17945,3,359.5,696,1,3,2,6,At-Risk
17946,2,149.57999999999998,232,2,2,1,5,Other
17947,1,176.68,36,3,2,1,6,Other
17948,1,358.56000000000006,146,2,2,2,6,Other
17949,116,107833.48,0,4,4,4,12,High-Value
17950,7,1166.29,71,3,4,3,10,High-Value
17951,4,1340.5800000000002,39,3,3,3,9,High-Value
17952,4,788.46,377,2,3,2,7,Other
17953,1,148.67000000000002,539,1,2,1,4,At-Risk
17954,19,3801.83,4,4,4,4,12,High-Value
17955,6,949.9,198,2,3,3,8,Other
17956,1,12.75,248,2,2,1,5,Other
17957,1,110.72,65,3,2,1,6,Other
17958,2,973.88,116,2,2,3,7,Other
17959,1,140.75,591,1,2,1,4,At-Risk
17960,3,135.08,170,2,3,1,6,Other
17961,100,2866.74,20,4,4,4,12,High-Value
17962,4,665.91,141,2,3,2,7,Other
17963,4,643.16,470,1,3,2,6,At-Risk
17964,2,463.21,31,3,2,2,7,Other
17965,29,7002.9,37,3,4,4,11,High-Value
17966,10,1963.92,37,3,4,3,10,High-Value
17967,2,223.42,371,2,2,1,5,Other
17968,4,590.4399999999999,373,2,3,2,7,Other
17969,20,2354.29,165,2,4,4,10,High-Value
17970,1,562.79,210,2,2,2,6,Other
17971,1,161.94,547,1,2,1,4,At-Risk
17972,1,135.19,241,2,2,1,5,Other
17973,1,337.04,51,3,2,1,6,Other
17974,6,1739.09,24,4,3,3,10,High-Value
17975,24,6693.03,14,4,4,4,12,High-Value
17976,1,321.79,371,2,2,1,5,Other
17977,2,1511.45,28,3,2,3,8,Other
17978,4,1159.99,364,2,3,3,8,Other
17979,4,729.01,35,3,3,2,8,Loyal
17980,4,1012.72,165,2,3,3,8,Other
17981,1,239.12,410,1,2,1,4,At-Risk
17982,1,138.18,680,1,2,1,4,At-Risk
17983,1,171.71,394,1,2,1,4,At-Risk
17984,5,1148.69,144,2,3,3,8,Other
17985,1,631.35,21,4,2,2,8,Other
17986,1,20.8,55,3,2,1,6,Other
17987,5,965.4399999999999,184,2,3,3,8,Other
17988,13,485.69,11,4,4,2,10,High-Value
17989,1,207.32999999999998,378,2,2,1,5,Other
17990,6,1527.6100000000001,236,2,3,3,8,Other
17991,3,298.65,224,2,3,1,6,Other
17992,1,252.88,388,1,2,1,4,At-Risk
17993,1,225.99,616,1,2,1,4,At-Risk
17994,11,2264.03,121,2,4,4,10,High-Value
17995,3,495.48,281,2,3,2,7,Other
17996,3,469.73,379,1,3,2,6,At-Risk
17997,8,1962.46,73,3,4,3,10,High-Value
17998,3,639.24,379,1,3,2,6,At-Risk
17999,3,528.46,36,3,3,2,8,Loyal
18000,1,124.25,563,1,2,1,4,At-Risk
18001,6,924.14,11,4,3,3,10,High-Value
18002,4,237.62,375,2,3,1,6,Other
18003,1,353.51,375,2,2,2,6,Other
18004,1,157.92,361,2,2,1,5,Other
18005,2,226.47,3,4,2,1,7,Other
18006,4,969.51,22,4,3,3,10,High-Value
18007,1,215.22,392,1,2,1,4,At-Risk
18008,23,19759.079999999998,69,3,4,4,11,High-Value
18009,8,2144.23,234,2,4,3,9,High-Value
18010,1,174.8,256,2,2,1,5,Other
18011,2,410.79,372,2,2,2,6,Other
18012,1,115.3,722,1,2,1,4,At-Risk
18013,2,187.29,154,2,2,1,5,Other
18014,1,154.26999999999998,27,3,2,1,6,Other
18015,1,120.03,3,4,2,1,7,Other
18016,7,1954.56,31,3,4,3,10,High-Value
18017,4,688.0,80,3,3,2,8,Loyal
18018,4,297.99,107,2,3,1,6,Other
18019,1,38.45,51,3,2,1,6,Other
18020,1,190.48000000000002,543,1,2,1,4,At-Risk
18021,2,216.41,509,1,2,1,4,At-Risk
18022,5,1506.6200000000001,35,3,3,3,9,High-Value
18024,2,389.78,152,2,2,2,6,Other
18025,6,1177.72,379,1,3,3,7,At-Risk
18026,2,2074.07,500,1,2,3,6,At-Risk
18027,1,115.31,98,2,2,1,5,Other
18028,1,192.05,582,1,2,1,4,At-Risk
18029,1,433.77,641,1,2,2,5,At-Risk
18030,2,230.64999999999998,3,4,2,1,7,Other
18031,1,451.3,378,2,2,2,6,Other
18032,1,73.5,333,2,2,1,5,Other
18033,1,93.82000000000001,64,3,2,1,6,Other
18034,3,753.35,21,4,3,2,9,High-Value
18035,5,1260.23,35,3,3,3,9,High-Value
18036,11,1545.49,31,3,4,3,10,High-Value
18037,15,167.42,153,2,4,1,7,Other
18038,1,141.48,555,1,2,1,4,At-Risk
18039,4,548.22,373,2,3,2,7,Other
18040,2,357.20000000000005,18,4,2,2,8,Other
18041,38,8018.7699999999995,11,4,4,4,12,High-Value
18042,2,281.15,53,3,2,1,6,Other
18043,3,529.29,24,4,3,2,9,High-Value
18044,18,3505.61,3,4,4,4,12,High-Value
18045,1,178.34,44,3,2,1,6,Other
18046,1,189.63,649,1,2,1,4,At-Risk
18047,2,326.09,380,1,2,1,4,At-Risk
18048,3,394.93,202,2,3,2,7,Other
18049,2,500.5,436,1,2,2,5,At-Risk
18050,2,412.06,358,2,2,2,6,Other
18051,7,2282.28,633,1,4,4,9,High-Value
18052,1,10877.18,564,1,2,4,7,At-Risk
18053,3,571.07,70,3,3,2,8,Loyal
18054,1,176.5,392,1,2,1,4,At-Risk
18055,14,10142.64,6,4,4,4,12,High-Value
18056,2,554.6,287,2,2,2,6,Other
18057,3,1168.14,392,1,3,3,7,At-Risk
18058,3,774.06,9,4,3,2,9,High-Value
18059,3,306.46,22,4,3,1,8,Loyal
18060,2,1185.46,407,1,2,3,6,At-Risk
18061,28,6083.81,21,4,4,4,12,High-Value
18062,6,1632.67,172,2,3,3,8,Other
18063,2,186.60000000000002,390,1,2,1,4,At-Risk
18064,11,4481.83,132,2,4,4,10,High-Value
18065,28,5846.63,5,4,4,4,12,High-Value
18066,3,1440.4,74,3,3,3,9,High-Value
18067,1,396.33,39,3,2,2,7,Other
18068,1,101.7,288,2,2,1,5,Other
18069,11,4449.02,25,3,4,4,11,High-Value
18070,1,314.1,668,1,2,1,4,At-Risk
18071,6,1169.68,257,2,3,3,8,Other
18072,1,247.44,185,2,2,1,5,Other
18073,12,3859.82,113,2,4,4,10,High-Value
18074,2,1019.44,373,2,2,3,7,Other
18075,20,5783.29,22,4,4,4,12,High-Value
18076,1,151.49,379,1,2,1,4,At-Risk
18077,18,4078.79,7,4,4,4,12,High-Value
18078,4,725.53,216,2,3,2,7,Other
18079,5,4203.93,44,3,3,4,10,High-Value
18080,2,1231.5,18,4,2,3,9,High-Value
18081,3,343.45,35,3,3,2,8,Loyal
18082,1,680.84,25,3,2,2,7,Other
18083,1,463.53000000000003,397,1,2,2,5,At-Risk
18084,3,795.23,15,4,3,2,9,High-Value
18085,4,1341.8500000000001,329,2,3,3,8,Other
18086,1,101.34,273,2,2,1,5,Other
18087,16,13908.720000000001,290,2,4,4,10,High-Value
18088,1,166.03,60,3,2,1,6,Other
18089,1,428.45,446,1,2,2,5,At-Risk
18090,1,321.9,421,1,2,1,4,At-Risk
18091,1,360.85,592,1,2,2,5,At-Risk
18092,18,14693.720000000001,1,4,4,4,12,High-Value
18093,8,4452.71,92,3,4,4,11,High-Value
18094,13,6391.52,81,3,4,4,11,High-Value
18095,5,2303.09,312,2,3,4,9,High-Value
18096,6,1638.16,11,4,3,3,10,High-Value
18097,11,4627.92,7,4,4,4,12,High-Value
18098,1,527.94,395,1,2,2,5,At-Risk
18099,1,168.31,126,2,2,1,5,Other
18100,1,451.56,549,1,2,2,5,At-Risk
18101,5,622.01,10,4,3,2,9,High-Value
18102,145,580987.04,0,4,4,4,12,High-Value
18103,1,105.8,548,1,2,1,4,At-Risk
18104,1,754.64,36,3,2,2,7,Other
18105,1,113.48000000000002,37,3,2,1,6,Other
18106,6,1441.06,329,2,3,3,8,Other
18107,1,165.88,441,1,2,1,4,At-Risk
18108,3,848.8100000000001,253,2,3,2,7,Other
18109,38,9555.71,1,4,4,4,12,High-Value
18110,2,392.28000000000003,19,4,2,2,8,Other
18111,1,405.85,588,1,2,2,5,At-Risk
18112,4,773.36,11,4,3,2,9,High-Value
18113,1,76.32000000000001,368,2,2,1,5,Other
18114,1,220.1,289,2,2,1,5,Other
18115,1,9.700000000000001,697,1,2,1,4,At-Risk
18116,13,2130.89,67,3,4,3,10,High-Value
18117,1,314.4,25,3,2,1,6,Other
18118,29,6218.62,10,4,4,4,12,High-Value
18119,1,180.7,367,2,2,1,5,Other
18120,1,111.15,213,2,2,1,5,Other
18121,2,653.3,148,2,2,2,6,Other
18122,6,1791.84,7,4,3,3,10,High-Value
18123,3,666.64,23,4,3,2,9,High-Value
18124,1,102.65,471,1,2,1,4,At-Risk
18125,4,1131.75,29,3,3,3,9,High-Value
18126,1,198.58,60,3,2,1,6,Other
18127,4,556.13,18,4,3,2,9,High-Value
18128,1,399.29,536,1,2,2,5,At-Risk
18129,1,112.55,242,2,2,1,5,Other
18130,3,1059.39,14,4,3,3,10,High-Value
18131,1,222.95999999999998,631,1,2,1,4,At-Risk
18132,1,220.13,503,1,2,1,4,At-Risk
18133,1,931.5,211,2,2,3,7,Other
18134,2,445.0,597,1,2,2,5,At-Risk
18135,10,1249.6200000000001,28,3,4,3,10,High-Value
18136,5,1631.36,62,3,3,3,9,High-Value
18137,2,145.99,550,1,2,1,4,At-Risk
18138,1,152.65,294,2,2,1,5,Other
18139,6,8438.34,17,4,3,4,11,High-Value
18140,1,536.41,473,1,2,2,5,At-Risk
18141,2,882.47,401,1,2,3,6,At-Risk
18142,2,1019.52,156,2,2,3,7,Other
18143,2,1000.16,116,2,2,3,7,Other
18144,19,4892.95,7,4,4,4,12,High-Value
18145,11,5609.74,12,4,4,4,12,High-Value
18146,2,160.35,140,2,2,1,5,Other
18147,2,179.34,45,3,2,1,6,Other
18148,1,112.85000000000001,646,1,2,1,4,At-Risk
18149,7,1553.96,50,3,4,3,10,High-Value
18150,3,566.58,31,3,3,2,8,Loyal
18151,6,1879.44,134,2,3,3,8,Other
18152,1,426.69,645,1,2,2,5,At-Risk
18153,1,246.22,658,1,2,1,4,At-Risk
18154,5,932.6,2,4,3,3,10,High-Value
18155,3,371.62,74,3,3,2,8,Loyal
18156,2,675.64,12,4,2,2,8,Other
18157,1,213.9,570,1,2,1,4,At-Risk
18158,2,453.4,8,4,2,2,8,Other
18159,1,530.15,300,2,2,2,6,Other
18160,3,1003.88,56,3,3,3,9,High-Value
18161,6,1803.1000000000001,14,4,3,3,10,High-Value
18162,1,371.51,731,1,2,2,5,At-Risk
18163,1,728.84,583,1,2,2,5,At-Risk
18164,1,399.65,36,3,2,2,7,Other
18165,1,302.46,176,2,2,1,5,Other
18166,1,175.5,623,1,2,1,4,At-Risk
18167,3,1384.8600000000001,22,4,3,3,10,High-Value
18168,16,3435.5,175,2,4,4,10,High-Value
18169,1,202.65,60,3,2,1,6,Other
18170,9,2878.0,32,3,4,4,11,High-Value
18171,9,2437.31,58,3,4,4,11,High-Value
18172,52,17467.24,14,4,4,4,12,High-Value
18173,5,2696.36,86,3,3,4,10,High-Value
18174,2,162.5,6,4,2,1,7,Other
18175,1,176.10000000000002,675,1,2,1,4,At-Risk
18176,1,476.35,357,2,2,2,6,Other
18177,9,2216.32,30,3,4,3,10,High-Value
18178,11,6103.74,128,2,4,4,10,High-Value
18179,8,2547.55,8,4,4,4,12,High-Value
18180,6,1843.75,4,4,3,3,10,High-Value
18181,5,1188.34,23,4,3,3,10,High-Value
18182,1,291.13,462,1,2,1,4,At-Risk
18183,2,632.07,226,2,2,2,6,Other
18184,1,49.8,14,4,2,1,7,Other
18185,1,304.25,248,2,2,1,5,Other
18186,1,329.58,722,1,2,1,4,At-Risk
18187,1,724.89,631,1,2,2,5,At-Risk
18188,6,3280.59,14,4,3,4,11,High-Value
18189,3,1403.73,77,3,3,3,9,High-Value
18190,5,745.62,191,2,3,2,7,Other
18191,2,529.4,261,2,2,2,6,Other
18192,1,957.97,71,3,2,3,8,Other
18193,3,1207.35,164,2,3,3,8,Other
18194,6,4162.04,81,3,3,4,10,High-Value
18195,1,101.16,386,1,2,1,4,At-Risk
18196,4,1455.27,94,3,3,3,9,High-Value
18197,1,230.1,575,1,2,1,4,At-Risk
18198,17,5425.56,3,4,4,4,12,High-Value
18199,1,344.75,683,1,2,2,5,At-Risk
18200,1,150.35,105,2,2,1,5,Other
18201,1,447.53000000000003,722,1,2,2,5,At-Risk
18202,3,1396.99,199,2,3,3,8,Other
18203,4,482.52,156,2,3,2,7,Other
18204,3,1975.3500000000001,70,3,3,3,9,High-Value
18205,2,517.36,35,3,2,2,7,Other
18206,1,314.65999999999997,552,1,2,1,4,At-Risk
18207,1,544.47,498,1,2,2,5,At-Risk
18208,1,360.08,565,1,2,2,5,At-Risk
18209,1,139.10000000000002,28,3,2,1,6,Other
18210,7,2768.83,1,4,4,4,12,High-Value
18211,5,600.07,25,3,3,2,8,Loyal
18212,2,514.37,325,2,2,2,6,Other
18213,1,232.48000000000002,236,2,2,1,5,Other
18214,4,1780.34,530,1,3,3,7,At-Risk
18215,5,2232.4900000000002,88,3,3,3,9,High-Value
18216,1,481.75,30,3,2,2,7,Other
18217,4,945.04,28,3,3,3,9,High-Value
18218,4,1121.84,210,2,3,3,8,Other
18219,17,3352.7000000000003,2,4,4,4,12,High-Value
18220,6,1921.76,226,2,3,3,8,Other
18221,6,1424.94,21,4,3,3,10,High-Value
18222,1,443.0,92,3,2,2,7,Other
18223,26,14000.85,4,4,4,4,12,High-Value
18224,1,158.95000000000002,263,2,2,1,5,Other
18225,26,13014.8,2,4,4,4,12,High-Value
18226,26,11878.880000000001,43,3,4,4,11,High-Value
18227,2,388.75,217,2,2,2,6,Other
18228,2,779.9,56,3,2,2,7,Other
18229,28,10150.51,11,4,4,4,12,High-Value
18230,9,4291.06,8,4,4,4,12,High-Value
18231,28,6848.27,191,2,4,4,10,High-Value
18232,4,592.97,81,3,3,2,8,Loyal
18233,1,440.0,325,2,2,2,6,Other
18234,1,179.6,551,1,2,1,4,At-Risk
18235,3,1796.48,71,3,3,3,9,High-Value
18236,12,1795.3500000000001,29,3,4,3,10,High-Value
18237,5,987.1,2,4,3,3,10,High-Value
18238,1,270.92,514,1,2,1,4,At-Risk
18239,6,1712.26,218,2,3,3,8,Other
18240,1,422.58,45,3,2,2,7,Other
18241,21,2986.9900000000002,9,4,4,4,12,High-Value
18242,8,3605.21,71,3,4,4,11,High-Value
18243,1,515.78,413,1,2,2,5,At-Risk
18244,2,568.64,430,1,2,2,5,At-Risk
18245,20,6324.9800000000005,6,4,4,4,12,High-Value
18246,3,758.8199999999999,23,4,3,2,9,High-Value
18247,3,839.73,414,1,3,2,6,At-Risk
18248,2,804.02,122,2,2,2,6,Other
18249,1,95.34,16,4,2,1,7,Other
18250,1,349.27,309,2,2,2,6,Other
18251,9,26278.86,86,3,4,4,11,High-Value
18252,7,1533.69,50,3,4,3,10,High-Value
18253,1,317.88,642,1,2,1,4,At-Risk
18254,1,267.9,580,1,2,1,4,At-Risk
18255,2,303.15,88,3,2,1,6,Other
18256,1,110.69999999999999,387,1,2,1,4,At-Risk
18257,12,4585.15,38,3,4,4,11,High-Value
18258,6,2059.67,463,1,3,3,7,At-Risk
18259,7,3941.9,24,4,4,4,12,High-Value
18260,23,9947.26,172,2,4,4,10,High-Value
18261,2,324.24,42,3,2,1,6,Other
18262,3,577.54,139,2,3,2,7,Other
18263,3,1213.16,25,3,3,3,9,High-Value
18264,1,603.25,498,1,2,2,5,At-Risk
18265,2,801.51,71,3,2,2,7,Other
18266,1,251.1,433,1,2,1,4,At-Risk
18267,1,269.37,672,1,2,1,4,At-Risk
18268,6,1490.23,133,2,3,3,8,Other
18269,1,168.60000000000002,365,2,2,1,5,Other
18270,3,444.55,37,3,3,2,8,Loyal
18271,2,680.85,609,1,2,2,5,At-Risk
18272,9,4385.9800000000005,2,4,4,4,12,High-Value
18273,4,357.0,1,4,3,2,9,High-Value
18274,1,175.92,29,3,2,1,6,Other
18275,2,741.85,577,1,2,2,5,At-Risk
18276,6,1656.52,43,3,3,3,9,High-Value
18277,5,1180.05,57,3,3,3,9,High-Value
18278,2,414.20000000000005,73,3,2,2,7,Other
18279,1,231.34,518,1,2,1,4,At-Risk
18280,2,488.15000000000003,277,2,2,2,6,Other
18281,2,201.14,180,2,2,1,5,Other
18282,2,178.05,7,4,2,1,7,Other
18283,22,2658.95,3,4,4,4,12,High-Value
18284,1,411.68,431,1,2,2,5,At-Risk
18285,1,377.0,660,1,2,2,5,At-Risk
18286,2,1246.43,476,1,2,3,6,At-Risk
18287,7,4132.99,42,3,4,4,11,High-Value
