customer_id,last_purchase,frequency,monetary,recency,R,F,M,RFM_Score,Segment
12346,2011-01-18 10:01:00,12,77556.46,324,2,4,4,10,High-Value
12347,2011-12-07 15:52:00,8,4921.53,1,4,4,4,12,High-Value
12348,2011-09-25 13:13:00,5,1658.4,74,3,3,3,9,High-Value
12349,2011-11-21 09:51:00,3,3678.69,17,4,2,4,10,High-Value
12350,2011-02-02 16:01:00,1,294.4,309,2,1,1,4,One-Time
12351,2010-11-29 15:23:00,1,300.93,374,2,1,1,4,One-Time
12352,2011-11-03 14:37:00,9,1729.54,35,3,4,3,10,High-Value
12353,2011-05-19 17:47:00,2,406.76,203,2,2,2,6,Other
12354,2011-04-21 13:11:00,1,1079.4,231,2,1,3,6,Other
12355,2011-05-09 13:49:00,2,947.61,213,2,2,3,7,Other
12356,2011-11-17 08:40:00,6,5611.73,21,4,3,4,11,High-Value
12357,2011-11-06 16:07:00,2,17437.66,32,3,2,4,9,High-Value
12358,2011-12-08 10:26:00,5,3447.07,0,4,3,4,11,High-Value
12359,2011-10-13 12:47:00,10,8873.39,56,3,4,4,11,High-Value
12360,2011-10-18 15:22:00,6,3612.89,51,3,3,4,10,High-Value
12361,2011-02-25 13:51:00,4,451.25,286,2,3,2,7,Other
12362,2011-12-06 15:40:00,10,4737.23,2,4,4,4,12,High-Value
12363,2011-08-22 10:18:00,2,552.0,108,2,2,2,6,Other
12364,2011-12-02 10:22:00,4,1208.1,6,4,3,3,10,High-Value
12365,2011-02-21 13:51:00,1,320.69,290,2,1,1,4,One-Time
12366,2010-03-16 10:28:00,1,500.24,632,1,1,2,4,At-Risk
12367,2011-12-05 16:48:00,1,150.9,3,4,1,1,6,One-Time
12368,2010-03-21 15:56:00,1,917.7,627,1,1,3,5,At-Risk
12369,2010-10-22 13:13:00,3,1511.15,412,1,2,3,6,At-Risk
12370,2011-10-19 14:51:00,7,3956.56,50,3,3,4,10,High-Value
12371,2011-10-11 10:43:00,4,3347.38,58,3,3,4,10,High-Value
12372,2011-09-29 12:12:00,3,1196.04,70,3,2,3,8,Other
12373,2011-02-01 13:10:00,3,927.65,310,2,2,3,7,Other
12374,2011-11-14 15:37:00,3,2669.22,24,4,2,4,10,High-Value
12375,2011-11-29 10:36:00,2,377.5,9,4,2,2,8,Other
12376,2010-11-15 12:15:00,2,383.15,388,1,2,2,5,At-Risk
12377,2011-01-28 15:45:00,4,3266.32,314,2,3,4,9,High-Value
12378,2011-08-02 10:34:00,2,5416.32,128,2,2,4,8,Other
12379,2011-09-19 10:09:00,4,1470.22,80,3,3,3,9,High-Value
12380,2011-11-18 11:27:00,8,7210.65,20,4,4,4,12,High-Value
12381,2011-12-05 12:44:00,3,1474.81,3,4,2,3,9,High-Value
12383,2011-06-08 08:02:00,5,1628.56,183,2,3,3,8,Other
12384,2011-11-11 08:39:00,2,425.27,27,3,2,2,7,Other
12385,2010-11-25 15:14:00,1,1668.4,378,2,1,3,6,Other
12386,2011-01-06 12:37:00,2,401.9,336,2,2,2,6,Other
12387,2010-10-20 16:27:00,1,143.94,414,1,1,1,3,At-Risk
12388,2011-11-24 12:30:00,8,3901.11,14,4,4,4,12,High-Value
12389,2010-11-02 11:52:00,3,1433.33,401,1,2,3,6,At-Risk
12390,2011-09-21 09:33:00,1,504.84,78,3,1,2,6,Other
12391,2011-11-18 12:07:00,6,2724.84,20,4,3,4,11,High-Value
12392,2010-04-27 14:04:00,1,234.75,590,1,1,1,3,At-Risk
12393,2011-09-28 15:41:00,6,2399.45,71,3,3,4,10,High-Value
12394,2011-10-07 08:08:00,2,1080.48,62,3,2,3,8,Other
12395,2011-11-20 15:21:00,15,4241.17,18,4,4,4,12,High-Value
12396,2010-02-03 13:22:00,1,931.43,673,1,1,3,5,At-Risk
12397,2011-11-04 09:52:00,2,2214.9,34,3,2,3,8,Other
12398,2011-10-25 10:27:00,1,1435.66,44,3,1,3,7,Other
12399,2011-08-12 13:15:00,7,1842.3,118,2,3,3,8,Other
12400,2010-10-21 13:45:00,1,205.25,413,1,1,1,3,At-Risk
12401,2011-02-09 13:50:00,1,69.3,302,2,1,1,4,One-Time
12402,2011-01-20 13:49:00,6,1136.9,322,2,3,3,8,Other
12403,2011-10-21 10:51:00,2,947.36,48,3,2,3,8,Other
12405,2011-07-14 08:52:00,1,1390.39,147,2,1,3,6,Other
12406,2011-11-17 19:22:00,5,6390.36,21,4,3,4,11,High-Value
12407,2011-10-21 10:11:00,5,1507.12,48,3,3,3,9,High-Value
12408,2011-11-07 12:27:00,8,3905.77,31,3,4,4,11,High-Value
12409,2011-09-22 10:38:00,7,23419.29,77,3,3,4,10,High-Value
12410,2011-02-04 10:39:00,3,773.71,307,2,2,2,6,Other
12411,2010-10-26 09:25:00,1,346.9,408,1,1,2,4,At-Risk
12412,2011-09-26 10:16:00,6,2404.93,73,3,3,4,10,High-Value
12413,2011-10-04 09:00:00,4,871.45,65,3,3,3,9,High-Value
12414,2011-05-06 14:51:00,4,532.41,216,2,3,2,7,Other
12415,2011-11-15 14:22:00,24,144033.37,23,4,4,4,12,High-Value
12416,2010-02-21 10:19:00,1,202.56,655,1,1,1,3,At-Risk
12417,2011-12-06 14:52:00,20,5998.41,2,4,4,4,12,High-Value
12418,2011-08-19 11:08:00,4,2021.2,111,2,3,3,8,Other
12419,2010-11-19 10:04:00,2,391.01,384,1,2,2,5,At-Risk
12420,2011-10-07 08:55:00,1,600.39,62,3,1,2,6,Other
12421,2011-11-24 09:07:00,6,874.6,14,4,3,3,10,High-Value
12422,2011-09-05 09:48:00,12,3639.35,94,3,4,4,11,High-Value
12423,2011-12-09 10:10:00,10,2301.39,-1,4,4,4,12,High-Value
12424,2011-06-30 12:06:00,4,3340.03,161,2,3,4,9,High-Value
12425,2011-09-22 17:31:00,2,1741.41,77,3,2,3,8,Other
12426,2011-05-29 12:26:00,2,1201.21,193,2,2,3,7,Other
12427,2011-11-18 08:56:00,3,699.8,20,4,2,2,8,Other
12428,2011-11-14 08:22:00,8,6405.26,24,4,4,4,12,High-Value
12429,2011-11-30 17:22:00,8,5842.41,8,4,4,4,12,High-Value
12430,2011-10-27 15:09:00,1,216.4,42,3,1,1,5,One-Time
12431,2011-11-04 11:55:00,25,10102.22,34,3,4,4,11,High-Value
12432,2011-10-28 11:43:00,4,4359.32,41,3,3,4,10,High-Value
12433,2011-12-09 10:02:00,10,16794.14,-1,4,4,4,12,High-Value
12434,2011-09-16 12:38:00,3,1103.43,83,3,2,3,8,Other
12435,2011-09-21 09:06:00,6,13925.93,78,3,3,4,10,High-Value
12436,2011-09-01 12:09:00,1,429.01,98,2,1,2,5,Other
12437,2011-12-08 11:35:00,38,11282.4,0,4,4,4,12,High-Value
12438,2011-11-25 13:28:00,2,2466.85,13,4,2,4,10,High-Value
12439,2010-01-26 12:11:00,2,1142.88,681,1,2,3,6,At-Risk
12440,2010-09-03 13:11:00,2,739.2,461,1,2,2,5,At-Risk
12441,2010-12-08 10:45:00,1,155.55,365,2,1,1,4,One-Time
12442,2011-12-06 14:22:00,1,144.06,2,4,1,1,6,One-Time
12443,2009-12-07 15:42:00,1,365.31,731,1,1,2,4,At-Risk
12444,2011-11-18 13:23:00,5,4085.46,20,4,3,4,11,High-Value
12445,2011-11-17 18:43:00,2,378.98,21,4,2,2,8,Other
12446,2011-10-13 12:50:00,1,1002.31,56,3,1,3,7,Other
12447,2011-04-10 13:25:00,1,431.49,242,2,1,2,5,Other
12448,2011-10-26 13:46:00,1,365.45,43,3,1,2,6,Other
12449,2011-11-17 13:46:00,5,4274.89,21,4,3,4,11,High-Value
12450,2011-07-06 14:41:00,5,688.2,155,2,3,2,7,Other
12451,2011-11-29 08:40:00,8,12629.88,9,4,4,4,12,High-Value
12452,2011-11-23 08:05:00,1,348.57,15,4,1,2,7,Other
12453,2011-07-28 14:08:00,1,707.09,133,2,1,2,5,Other
12454,2011-10-14 17:13:00,4,16459.78,55,3,3,4,10,High-Value
12455,2011-09-27 15:31:00,9,5722.95,72,3,4,4,11,High-Value
12456,2011-10-26 14:41:00,3,2581.04,43,3,2,4,9,High-Value
12457,2011-10-04 13:13:00,7,2555.91,65,3,3,4,10,High-Value
12458,2011-09-29 15:25:00,4,1502.49,70,3,3,3,9,High-Value
12459,2010-04-13 14:53:00,1,398.36,604,1,1,2,4,At-Risk
12460,2010-09-09 13:51:00,1,296.65,455,1,1,1,3,At-Risk
12461,2011-07-08 10:23:00,1,626.88,153,2,1,2,5,Other
12462,2011-11-21 09:11:00,2,937.59,17,4,2,3,9,High-Value
12463,2011-10-17 13:44:00,4,1200.78,52,3,3,3,9,High-Value
12464,2011-11-29 13:33:00,8,957.05,9,4,4,3,11,High-Value
12465,2011-11-22 16:34:00,2,682.19,16,4,2,2,8,Other
12467,2010-10-12 15:41:00,1,132.8,422,1,1,1,3,At-Risk
12468,2011-06-05 11:36:00,5,3238.74,186,2,3,4,9,High-Value
12469,2010-07-05 12:40:00,2,3070.54,521,1,2,4,7,At-Risk
12470,2010-01-19 11:01:00,1,211.95,688,1,1,1,3,At-Risk
12471,2011-12-07 15:43:00,71,35099.9,1,4,4,4,12,High-Value
12472,2011-11-07 14:01:00,19,14971.29,31,3,4,4,11,High-Value
12473,2011-10-17 11:27:00,3,2585.73,52,3,2,4,9,High-Value
12474,2011-11-22 14:39:00,29,11310.75,16,4,4,4,12,High-Value
12475,2011-10-17 10:10:00,2,1065.64,52,3,2,3,8,Other
12476,2011-11-24 12:40:00,18,12319.91,14,4,4,4,12,High-Value
12477,2011-11-17 09:51:00,9,20276.37,21,4,4,4,12,High-Value
12478,2011-12-06 09:56:00,1,545.99,2,4,1,2,7,Other
12479,2011-11-28 13:26:00,1,473.2,10,4,1,2,7,Other
12480,2011-11-11 14:52:00,7,4834.85,27,3,3,4,10,High-Value
12481,2011-11-17 08:29:00,14,11033.51,21,4,4,4,12,High-Value
12482,2010-05-12 16:51:00,27,21941.72,575,1,4,4,9,High-Value
12483,2011-11-22 17:02:00,19,4069.18,16,4,4,4,12,High-Value
12484,2011-11-04 15:18:00,9,5557.1,34,3,4,4,11,High-Value
12485,2010-06-28 15:22:00,1,708.1,528,1,1,2,4,At-Risk
12486,2010-10-04 12:14:00,1,917.28,430,1,1,3,5,At-Risk
12487,2009-12-09 11:36:00,1,285.3,729,1,1,1,3,At-Risk
12488,2011-11-30 08:50:00,3,1244.66,8,4,2,3,9,High-Value
12489,2011-01-07 13:13:00,1,298.93,335,2,1,1,4,One-Time
12490,2011-12-04 16:07:00,20,8764.64,4,4,4,4,12,High-Value
12491,2011-11-01 12:18:00,1,424.4,37,3,1,2,6,Other
12492,2011-10-07 15:15:00,3,607.21,62,3,2,2,7,Other
12493,2011-06-27 10:17:00,2,379.74,164,2,2,2,6,Other
12494,2011-11-24 09:34:00,9,1563.27,14,4,4,3,11,High-Value
12495,2010-03-09 10:53:00,1,277.4,639,1,1,1,3,At-Risk
12496,2010-03-29 14:06:00,2,45.34,619,1,2,1,4,At-Risk
12497,2011-09-19 12:29:00,3,5996.5,80,3,2,4,9,High-Value
12498,2011-11-18 12:53:00,3,349.7,20,4,2,2,8,Other
12499,2010-05-28 15:12:00,1,357.72,559,1,1,2,4,At-Risk
12500,2011-11-16 16:20:00,18,5559.21,22,4,4,4,12,High-Value
12501,2011-01-07 12:28:00,1,2025.39,335,2,1,3,6,Other
12502,2011-09-05 11:52:00,5,2995.87,94,3,3,4,10,High-Value
12503,2010-05-04 13:59:00,1,896.0,583,1,1,3,5,At-Risk
12504,2011-11-21 16:02:00,4,689.05,17,4,3,2,9,High-Value
12505,2010-10-27 09:18:00,1,787.2,407,1,1,2,4,At-Risk
12506,2011-04-21 08:54:00,1,73.5,231,2,1,1,4,One-Time
12507,2011-07-28 17:09:00,4,1508.06,133,2,3,3,8,Other
12508,2011-11-13 15:37:00,2,397.88,25,3,2,2,7,Other
12509,2011-02-28 14:45:00,1,158.5,283,2,1,1,4,One-Time
12510,2011-07-20 10:15:00,7,3039.03,141,2,3,4,9,High-Value
12511,2010-10-07 10:39:00,1,3084.02,427,1,1,4,6,At-Risk
12512,2011-10-04 14:55:00,2,132.18,65,3,2,1,6,Other
12513,2011-08-19 10:51:00,1,558.29,111,2,1,2,5,Other
12514,2011-03-17 16:38:00,2,1597.76,266,2,2,3,7,Other
12515,2010-12-21 15:43:00,1,278.7,352,2,1,1,4,One-Time
12516,2011-09-23 09:13:00,4,2288.62,76,3,3,4,10,High-Value
12517,2011-11-11 13:57:00,4,2301.6,27,3,3,4,10,High-Value
12518,2011-12-09 10:13:00,5,1840.89,-1,4,3,3,10,High-Value
12519,2011-10-07 09:26:00,2,626.54,62,3,2,2,7,Other
12520,2011-09-21 15:23:00,5,2346.26,78,3,3,4,10,High-Value
12521,2011-07-20 10:51:00,1,545.68,141,2,1,2,5,Other
12522,2011-10-31 15:30:00,2,156.72,38,3,2,1,6,Other
12523,2011-11-20 12:55:00,23,4010.35,18,4,4,4,12,High-Value
12524,2011-11-30 15:31:00,17,9794.11,8,4,4,4,12,High-Value
12525,2010-07-29 16:08:00,3,883.73,497,1,2,3,6,At-Risk
12526,2011-12-09 12:09:00,3,1172.66,-1,4,2,3,9,High-Value
12527,2011-09-19 11:55:00,5,717.51,80,3,3,2,8,Loyal
12528,2011-11-30 14:40:00,6,1645.48,8,4,3,3,10,High-Value
12529,2010-06-29 13:10:00,1,316.48,527,1,1,1,3,At-Risk
12530,2011-10-11 12:34:00,9,3381.26,58,3,4,4,11,High-Value
12531,2011-11-25 11:12:00,2,1771.2,13,4,2,3,9,High-Value
12532,2011-11-09 13:47:00,1,313.83,29,3,1,1,5,One-Time
12533,2010-03-22 10:56:00,2,1223.89,626,1,2,3,6,At-Risk
12534,2011-08-01 10:26:00,1,981.18,129,2,1,3,6,Other
12535,2011-09-09 08:48:00,2,716.35,90,3,2,2,7,Other
12536,2011-10-11 14:52:00,1,4279.71,58,3,1,4,8,Other
12537,2010-10-27 08:36:00,1,612.94,407,1,1,2,4,At-Risk
12538,2011-11-10 17:16:00,2,640.45,28,3,2,2,7,Other
12539,2011-11-17 13:30:00,7,11186.75,21,4,3,4,11,High-Value
12540,2011-11-20 11:31:00,32,19250.49,18,4,4,4,12,High-Value
12541,2011-11-10 10:40:00,3,841.18,28,3,2,2,7,Other
12542,2010-08-12 19:12:00,2,481.88,483,1,2,2,5,At-Risk
12543,2010-09-17 15:51:00,1,840.25,447,1,1,2,4,At-Risk
12544,2011-11-03 16:15:00,1,316.7,35,3,1,1,5,One-Time
12545,2011-09-25 13:39:00,2,832.39,74,3,2,2,7,Other
12546,2011-10-24 12:09:00,2,1021.5,45,3,2,3,8,Other
12547,2011-05-26 12:38:00,3,299.58,196,2,2,1,5,Other
12548,2011-06-26 15:35:00,1,67.2,165,2,1,1,4,One-Time
12549,2010-05-13 12:05:00,5,1570.68,574,1,3,3,7,At-Risk
12550,2011-09-21 14:35:00,1,824.83,78,3,1,2,6,Other
12551,2010-12-17 11:23:00,1,168.0,356,2,1,1,4,One-Time
12552,2011-10-31 12:11:00,1,317.82,38,3,1,1,5,One-Time
12553,2011-12-01 16:38:00,12,4104.75,7,4,4,4,12,High-Value
12554,2010-09-17 12:29:00,1,384.5,447,1,1,2,4,At-Risk
12556,2011-10-20 13:06:00,2,599.56,49,3,2,2,7,Other
12557,2011-11-23 16:59:00,8,18096.14,15,4,4,4,12,High-Value
12558,2011-12-02 10:41:00,1,269.96,6,4,1,1,6,One-Time
12559,2011-02-02 09:49:00,2,525.71,309,2,2,2,6,Other
12560,2011-12-04 13:54:00,2,1918.01,4,4,2,3,9,High-Value
12561,2011-02-10 11:39:00,1,238.85,301,2,1,1,4,One-Time
12562,2011-12-01 17:20:00,9,4426.92,7,4,4,4,12,High-Value
12563,2010-10-27 09:52:00,1,221.24,407,1,1,1,3,At-Risk
12564,2011-03-23 14:55:00,1,402.9,260,2,1,2,5,Other
12565,2011-02-24 10:34:00,1,145.92,287,2,1,1,4,One-Time
12566,2011-09-14 14:30:00,1,297.65,85,3,1,1,5,One-Time
12567,2011-11-17 11:02:00,15,10741.48,21,4,4,4,12,High-Value
12568,2010-03-05 09:15:00,1,52.0,643,1,1,1,3,At-Risk
12569,2011-12-07 16:24:00,32,3152.69,1,4,4,4,12,High-Value
12571,2011-10-31 10:19:00,2,519.61,38,3,2,2,7,Other
12572,2011-12-01 09:20:00,2,912.42,7,4,2,3,9,High-Value
12573,2011-04-26 15:52:00,5,717.41,226,2,3,2,7,Other
12574,2011-01-28 09:20:00,1,182.45,314,2,1,1,4,One-Time
12575,2010-09-08 13:09:00,2,568.82,456,1,2,2,5,At-Risk
12576,2011-11-04 10:11:00,8,2062.72,34,3,4,3,10,High-Value
12577,2011-11-04 13:24:00,8,1613.15,34,3,4,3,10,High-Value
12578,2011-11-18 13:30:00,4,4026.45,20,4,3,4,11,High-Value
12579,2011-09-22 17:15:00,1,386.42,77,3,1,2,6,Other
12580,2011-04-07 10:24:00,2,962.9,245,2,2,3,7,Other
12581,2011-10-31 08:56:00,1,179.71,38,3,1,1,5,One-Time
12582,2011-04-15 08:45:00,4,1820.4,237,2,3,3,8,Other
12583,2011-12-07 08:07:00,27,12493.58,1,4,4,4,12,High-Value
12584,2011-12-06 09:35:00,9,2254.15,2,4,4,4,12,High-Value
12585,2011-04-19 13:39:00,2,1824.1,233,2,2,3,7,Other
12586,2011-11-22 16:24:00,4,2062.67,16,4,3,3,10,High-Value
12587,2011-12-02 12:47:00,1,104.0,6,4,1,1,6,One-Time
12588,2011-10-31 15:01:00,3,718.78,38,3,2,2,7,Other
12589,2011-11-11 10:19:00,6,3294.91,27,3,3,4,10,High-Value
12590,2011-05-12 14:46:00,1,9341.26,210,2,1,4,7,Other
12591,2011-01-26 14:35:00,3,1114.95,316,2,2,3,7,Other
12592,2011-09-08 15:04:00,4,1723.64,91,3,3,3,9,High-Value
12593,2011-08-23 12:43:00,3,382.1,107,2,2,2,6,Other
12594,2011-11-02 12:20:00,14,4890.11,36,3,4,4,11,High-Value
12595,2010-07-23 09:10:00,1,281.02,503,1,1,1,3,At-Risk
12596,2011-10-19 13:02:00,2,450.27,50,3,2,2,7,Other
12597,2011-11-20 13:33:00,4,3195.22,18,4,3,4,11,High-Value
12598,2011-11-30 12:18:00,10,4192.09,8,4,4,4,12,High-Value
12599,2011-11-10 13:34:00,13,2026.72,28,3,4,3,10,High-Value
12600,2011-11-11 10:29:00,20,4385.85,27,3,4,4,11,High-Value
12601,2011-06-03 10:17:00,6,573.26,188,2,3,2,7,Other
12602,2011-10-12 11:22:00,1,153.12,57,3,1,1,5,One-Time
12603,2011-11-18 10:42:00,1,613.2,20,4,1,2,7,Other
12604,2011-09-21 14:08:00,2,236.18,78,3,2,1,6,Other
12605,2010-11-28 14:18:00,3,1124.95,375,2,2,3,7,Other
12607,2011-10-10 16:06:00,1,1579.51,59,3,1,3,7,Other
12608,2010-10-31 10:49:00,1,415.79,403,1,1,2,4,At-Risk
12609,2011-09-22 16:34:00,9,3021.86,77,3,4,4,11,High-Value
12610,2011-11-17 09:34:00,4,1747.54,21,4,3,3,10,High-Value
12611,2011-10-18 13:12:00,1,1193.32,51,3,1,3,7,Other
12612,2011-09-26 15:35:00,1,668.04,73,3,1,2,6,Other
12613,2011-10-13 14:59:00,9,6277.37,56,3,4,4,11,High-Value
12614,2011-03-07 10:22:00,1,315.6,276,2,1,1,4,One-Time
12615,2011-12-07 15:02:00,8,5362.98,1,4,4,4,12,High-Value
12616,2011-09-05 15:17:00,3,1023.1,94,3,2,3,8,Other
12617,2011-11-10 14:39:00,1,352.98,28,3,1,2,6,Other
12618,2011-11-18 11:10:00,1,137.31,20,4,1,1,6,One-Time
12619,2011-11-23 14:52:00,9,3085.7,15,4,4,4,12,High-Value
12620,2011-11-25 10:20:00,3,1303.41,13,4,2,3,9,High-Value
12621,2011-12-08 11:25:00,35,22097.2,0,4,4,4,12,High-Value
12622,2011-04-21 16:39:00,1,162.1,231,2,1,1,4,One-Time
12623,2011-03-08 13:50:00,7,3315.84,275,2,3,4,9,High-Value
12624,2011-08-25 15:04:00,2,569.13,105,2,2,2,6,Other
12625,2011-05-12 09:54:00,4,4678.88,210,2,3,4,9,High-Value
12626,2011-11-16 16:06:00,9,5954.48,22,4,4,4,12,High-Value
12627,2011-11-29 12:07:00,6,4082.53,9,4,3,4,11,High-Value
12628,2011-12-05 13:15:00,3,732.46,3,4,2,2,8,Other
12629,2010-11-19 09:18:00,2,1198.22,384,1,2,3,6,At-Risk
12630,2011-11-30 10:48:00,2,1030.88,8,4,2,3,9,High-Value
12631,2011-10-13 13:53:00,6,3321.57,56,3,3,4,10,High-Value
12632,2010-07-07 09:39:00,2,714.88,519,1,2,2,5,At-Risk
12633,2011-10-12 11:40:00,7,5156.16,57,3,3,4,10,High-Value
12634,2010-06-09 15:41:00,1,360.0,547,1,1,2,4,At-Risk
12635,2011-09-11 11:04:00,4,2624.41,88,3,3,4,10,High-Value
12637,2011-10-03 13:46:00,12,8085.81,66,3,4,4,11,High-Value
12638,2011-11-06 13:11:00,2,681.49,32,3,2,2,7,Other
12639,2011-04-15 12:48:00,3,1072.37,237,2,2,3,7,Other
12640,2011-11-16 11:52:00,3,994.58,22,4,2,3,9,High-Value
12641,2011-08-16 13:26:00,1,145.9,114,2,1,1,4,One-Time
12642,2011-11-14 15:03:00,3,905.26,24,4,2,3,9,High-Value
12643,2011-08-03 12:56:00,11,7803.82,127,2,4,4,10,High-Value
12644,2011-08-02 10:33:00,4,1900.49,128,2,3,3,8,Other
12645,2011-11-06 12:38:00,8,3215.3,32,3,4,4,11,High-Value
12646,2011-12-05 10:14:00,2,1346.97,3,4,2,3,9,High-Value
12647,2011-11-17 12:56:00,35,14109.55,21,4,4,4,12,High-Value
12648,2011-07-08 11:55:00,4,1039.0,153,2,3,3,8,Other
12649,2011-08-24 14:41:00,8,2096.65,106,2,4,3,9,High-Value
12650,2011-12-06 16:34:00,1,242.44,2,4,1,1,6,One-Time
12651,2011-01-09 12:46:00,4,377.75,333,2,3,2,7,Other
12652,2011-01-12 15:00:00,2,891.03,330,2,2,3,7,Other
12653,2011-07-14 10:41:00,3,4160.83,147,2,2,4,8,Other
12654,2011-11-29 10:10:00,5,529.98,9,4,3,2,9,High-Value
12655,2010-10-12 09:17:00,1,243.35,422,1,1,1,3,At-Risk
12656,2011-11-22 13:42:00,8,5723.83,16,4,4,4,12,High-Value
12657,2011-11-28 15:47:00,4,1427.18,10,4,3,3,10,High-Value
12658,2011-11-21 10:22:00,1,632.05,17,4,1,2,7,Other
12659,2011-11-10 11:53:00,1,73.68,28,3,1,1,5,One-Time
12660,2011-11-28 13:26:00,1,227.1,10,4,1,1,6,One-Time
12661,2010-09-29 16:46:00,1,162.0,435,1,1,1,3,At-Risk
12662,2011-12-09 11:59:00,20,6130.54,-1,4,4,4,12,High-Value
12663,2010-03-25 09:40:00,2,185.4,623,1,2,1,4,At-Risk
12664,2011-12-01 17:07:00,11,5420.04,7,4,4,4,12,High-Value
12665,2011-01-19 08:34:00,3,259.6,323,2,2,1,5,Other
12666,2010-11-10 16:40:00,1,1248.42,393,1,1,3,5,At-Risk
12667,2011-10-12 17:00:00,1,460.13,57,3,1,2,6,Other
12668,2011-11-28 10:56:00,9,9906.03,10,4,4,4,12,High-Value
12669,2011-07-12 09:54:00,2,1427.73,149,2,2,3,7,Other
12670,2011-11-29 15:23:00,7,3436.29,9,4,3,4,11,High-Value
12671,2010-04-12 16:30:00,1,2622.48,605,1,1,4,6,At-Risk
12672,2011-01-14 09:20:00,2,407.05,328,2,2,2,6,Other
12673,2011-12-04 13:55:00,3,1140.02,4,4,2,3,9,High-Value
12674,2011-11-01 12:12:00,4,1844.6,37,3,3,3,9,High-Value
12675,2010-06-04 09:49:00,2,873.25,552,1,2,3,6,At-Risk
12676,2011-11-15 12:25:00,10,2333.09,23,4,4,4,12,High-Value
12677,2010-06-02 14:30:00,2,359.1,554,1,2,2,5,At-Risk
12678,2011-10-28 13:04:00,15,32595.18,41,3,4,4,11,High-Value
12679,2011-10-12 12:30:00,4,951.02,57,3,3,3,9,High-Value
12680,2011-12-09 12:50:00,4,790.81,-1,4,3,2,9,High-Value
12681,2011-11-25 11:33:00,44,26936.76,13,4,4,4,12,High-Value
12682,2011-12-06 10:00:00,51,20736.22,2,4,4,4,12,High-Value
12683,2011-12-05 16:28:00,20,10445.7,3,4,4,4,12,High-Value
12684,2011-12-02 09:53:00,6,2073.63,6,4,3,3,10,High-Value
12685,2011-11-11 13:46:00,6,2575.08,27,3,3,4,10,High-Value
12686,2010-12-03 09:51:00,1,71.14,370,2,1,1,4,One-Time
12687,2010-08-16 12:12:00,1,1858.91,479,1,1,3,5,At-Risk
12688,2011-08-18 08:49:00,1,4873.81,112,2,1,4,7,Other
12689,2011-11-14 08:31:00,2,1139.61,24,4,2,3,9,High-Value
12690,2011-05-18 09:09:00,1,335.01,204,2,1,1,4,One-Time
12691,2011-11-11 16:49:00,6,1044.4,27,3,3,3,9,High-Value
12692,2010-03-12 14:02:00,1,110.95,636,1,1,1,3,At-Risk
12693,2011-08-04 17:51:00,7,1415.02,126,2,3,3,8,Other
12694,2011-09-30 13:06:00,3,1663.35,69,3,2,3,8,Other
12695,2011-12-02 13:22:00,7,1371.12,6,4,3,3,10,High-Value
12696,2010-10-01 10:43:00,2,731.91,433,1,2,2,5,At-Risk
12697,2011-11-11 08:47:00,3,757.59,27,3,2,2,7,Other
12698,2010-04-28 15:51:00,1,285.75,589,1,1,1,3,At-Risk
12699,2010-10-18 12:07:00,1,566.11,416,1,1,2,4,At-Risk
12700,2011-12-02 10:47:00,4,4525.99,6,4,3,4,11,High-Value
12701,2011-09-21 10:47:00,6,2248.41,78,3,3,4,10,High-Value
12702,2011-11-20 10:36:00,1,201.0,18,4,1,1,6,One-Time
12703,2011-09-29 17:52:00,4,898.53,70,3,3,3,9,High-Value
12704,2011-12-02 13:15:00,8,1740.84,6,4,4,3,11,High-Value
12705,2011-11-24 13:17:00,13,11114.1,14,4,4,4,12,High-Value
12707,2011-02-21 08:38:00,1,603.42,290,2,1,2,5,Other
12708,2011-11-10 09:52:00,18,4559.66,28,3,4,4,11,High-Value
12709,2011-11-24 15:38:00,32,29487.18,14,4,4,4,12,High-Value
12710,2011-09-04 12:00:00,3,1023.02,95,2,2,3,7,Other
12711,2010-04-07 11:59:00,2,1213.05,610,1,2,3,6,At-Risk
12712,2011-11-11 08:19:00,21,5985.03,27,3,4,4,11,High-Value
12713,2011-12-09 12:16:00,1,794.55,-1,4,1,2,7,Other
12714,2011-11-30 15:43:00,12,12815.71,8,4,4,4,12,High-Value
12715,2011-08-25 15:22:00,1,263.36,105,2,1,1,4,One-Time
12716,2011-12-06 08:55:00,2,963.49,2,4,2,3,9,High-Value
12717,2011-07-11 14:47:00,3,1058.91,150,2,2,3,7,Other
12718,2011-09-29 16:38:00,1,202.25,70,3,1,1,5,One-Time
12719,2011-12-04 13:45:00,2,572.95,4,4,2,2,8,Other
12720,2011-12-07 08:03:00,29,6905.28,1,4,4,4,12,High-Value
12721,2011-11-08 12:13:00,8,3635.08,30,3,4,4,11,High-Value
12722,2011-09-15 14:50:00,4,979.63,84,3,3,3,9,High-Value
12723,2011-12-06 10:19:00,5,707.07,2,4,3,2,9,High-Value
12724,2011-12-04 16:02:00,7,2083.52,4,4,3,3,10,High-Value
12725,2010-12-03 15:45:00,3,1906.76,370,2,2,3,7,Other
12726,2011-11-11 13:35:00,11,3690.6,27,3,4,4,11,High-Value
12727,2011-11-29 11:46:00,10,4905.53,9,4,4,4,12,High-Value
12728,2011-09-29 15:31:00,5,926.17,70,3,3,3,9,High-Value
12729,2011-08-18 11:40:00,1,417.01,112,2,1,2,5,Other
12730,2010-07-06 12:19:00,1,703.25,520,1,1,2,4,At-Risk
12731,2011-11-16 11:59:00,17,25631.71,22,4,4,4,12,High-Value
12732,2011-06-13 11:33:00,1,218.26,178,2,1,1,4,One-Time
12733,2011-04-19 16:19:00,4,2424.02,233,2,3,4,9,High-Value
12734,2010-12-22 12:47:00,3,603.65,351,2,2,2,6,Other
12735,2011-01-28 13:37:00,2,689.57,314,2,2,2,6,Other
12736,2011-01-11 07:57:00,1,144.0,331,2,1,1,4,One-Time
12738,2010-12-02 18:27:00,1,137.35,371,2,1,1,4,One-Time
12739,2011-09-01 17:45:00,2,2421.23,98,2,2,4,8,Other
12740,2011-10-07 10:44:00,1,427.6,62,3,1,2,6,Other
12741,2010-06-24 16:24:00,1,236.07,532,1,1,1,3,At-Risk
12742,2010-03-24 12:43:00,1,1201.52,624,1,1,3,5,At-Risk
12743,2011-07-28 16:21:00,2,540.13,133,2,2,2,6,Other
12744,2011-10-14 14:54:00,8,13158.16,55,3,4,4,11,High-Value
12745,2010-08-10 10:14:00,2,723.85,485,1,2,2,5,At-Risk
12746,2010-06-17 10:41:00,1,254.55,539,1,1,1,3,At-Risk
12747,2011-12-07 14:34:00,26,8898.48,1,4,4,4,12,High-Value
12748,2011-12-09 12:20:00,322,49176.74,-1,4,4,4,12,High-Value
12749,2011-12-06 09:56:00,9,6847.36,2,4,4,4,12,High-Value
12750,2011-08-03 09:13:00,1,275.88,127,2,1,1,4,One-Time
12751,2010-09-21 12:49:00,1,268.27,443,1,1,1,3,At-Risk
12752,2011-09-19 13:32:00,1,4366.78,80,3,1,4,8,Other
12753,2011-11-17 10:52:00,6,21429.39,21,4,3,4,11,High-Value
12754,2011-04-18 09:00:00,3,3010.74,234,2,2,4,8,Other
12755,2011-03-04 12:42:00,11,5236.26,279,2,4,4,10,High-Value
12756,2011-09-14 09:31:00,1,112.08,85,3,1,1,5,One-Time
12757,2011-11-24 12:30:00,9,4176.75,14,4,4,4,12,High-Value
12758,2011-08-15 10:22:00,7,9903.24,115,2,3,4,9,High-Value
12759,2011-10-18 14:49:00,8,4618.74,51,3,4,4,11,High-Value
12760,2010-09-10 08:50:00,1,317.8,454,1,1,1,3,At-Risk
12761,2010-09-01 10:47:00,1,712.95,463,1,1,2,4,At-Risk
12762,2011-12-02 10:23:00,2,1702.52,6,4,2,3,9,High-Value
12763,2011-07-24 14:12:00,2,494.08,137,2,2,2,6,Other
12764,2011-01-27 10:19:00,1,1693.88,315,2,1,3,6,Other
12765,2010-08-24 13:51:00,6,1299.58,471,1,3,3,7,At-Risk
12766,2011-12-06 08:46:00,9,8134.99,2,4,4,4,12,High-Value
12767,2010-11-29 09:38:00,1,949.82,374,2,1,3,6,Other
12768,2010-09-15 12:08:00,1,168.69,449,1,1,1,3,At-Risk
12769,2011-04-15 10:25:00,1,1143.6,237,2,1,3,6,Other
12770,2011-05-13 09:33:00,2,3246.45,209,2,2,4,8,Other
12771,2010-08-11 11:51:00,1,226.3,484,1,1,1,3,At-Risk
12772,2011-10-11 09:19:00,1,752.47,58,3,1,2,6,Other
12773,2010-05-24 17:30:00,1,124.25,563,1,1,1,3,At-Risk
12774,2010-06-22 10:38:00,1,83.7,534,1,1,1,3,At-Risk
12775,2011-11-22 16:33:00,7,1551.12,16,4,3,3,10,High-Value
12776,2010-02-10 12:11:00,1,27.5,666,1,1,1,3,At-Risk
12777,2010-09-08 11:35:00,1,519.45,456,1,1,2,4,At-Risk
12778,2011-11-20 11:30:00,9,1541.68,18,4,4,3,11,High-Value
12779,2011-11-02 11:43:00,14,6474.11,36,3,4,4,11,High-Value
12780,2010-04-20 09:40:00,1,322.4,597,1,1,1,3,At-Risk
12781,2011-10-07 10:37:00,2,786.74,62,3,2,2,7,Other
12782,2011-12-05 09:16:00,11,3862.24,3,4,4,4,12,High-Value
12783,2011-12-07 15:56:00,4,1295.87,1,4,3,3,10,High-Value
12784,2011-11-24 12:53:00,2,1511.15,14,4,2,3,9,High-Value
12785,2010-12-10 13:48:00,3,904.4,363,2,2,3,7,Other
12786,2010-04-09 12:12:00,1,668.5,608,1,1,2,4,At-Risk
12787,2011-11-30 08:44:00,4,799.18,8,4,3,2,9,High-Value
12788,2010-09-02 14:21:00,4,384.9,462,1,3,2,6,At-Risk
12789,2011-10-05 13:34:00,3,225.35,64,3,2,1,6,Other
12790,2011-05-31 14:14:00,2,546.85,191,2,2,2,6,Other
12791,2010-12-01 11:27:00,5,656.83,372,2,3,2,7,Other
12792,2011-03-28 11:36:00,2,715.01,255,2,2,2,6,Other
12793,2011-01-09 12:12:00,3,745.53,333,2,2,2,6,Other
12794,2011-10-17 14:54:00,2,860.41,52,3,2,3,8,Other
12795,2011-11-21 10:27:00,1,318.48,17,4,1,1,6,One-Time
12796,2010-03-21 15:49:00,1,351.0,627,1,1,2,4,At-Risk
12797,2010-12-09 10:55:00,2,468.08,364,2,2,2,6,Other
12798,2011-11-29 15:52:00,4,8510.93,9,4,3,4,11,High-Value
12799,2010-06-28 15:57:00,1,219.35,528,1,1,1,3,At-Risk
12800,2010-08-26 14:11:00,2,500.25,469,1,2,2,5,At-Risk
12801,2010-07-27 09:38:00,1,871.82,499,1,1,3,5,At-Risk
12802,2011-06-06 09:36:00,5,2186.42,185,2,3,3,8,Other
12803,2010-11-11 14:57:00,1,1017.81,392,1,1,3,5,At-Risk
12804,2010-08-31 11:58:00,2,325.37,464,1,2,1,4,At-Risk
12805,2010-11-23 12:27:00,4,1230.95,380,1,3,3,7,At-Risk
12806,2010-05-16 13:49:00,2,2558.96,571,1,2,4,7,At-Risk
12807,2010-11-21 14:21:00,1,250.35,382,1,1,1,3,At-Risk
12808,2011-11-03 10:05:00,5,748.7,35,3,3,2,8,Loyal
12809,2011-06-15 10:51:00,3,1384.34,176,2,2,3,7,Other
12810,2010-06-23 10:53:00,2,534.99,533,1,2,2,5,At-Risk
12811,2011-03-23 10:55:00,4,893.9,260,2,3,3,8,Other
12812,2011-10-26 09:54:00,1,229.64,43,3,1,1,5,One-Time
12813,2010-07-26 09:50:00,3,1621.8,500,1,2,3,6,At-Risk
12814,2011-08-30 12:11:00,1,85.92,100,2,1,1,4,One-Time
12815,2011-07-15 10:21:00,2,863.46,146,2,2,3,7,Other
12816,2011-09-05 12:41:00,2,452.2,94,3,2,2,7,Other
12817,2011-03-03 16:28:00,3,570.98,280,2,2,2,6,Other
12818,2011-03-23 12:06:00,1,1182.08,260,2,1,3,6,Other
12819,2010-09-07 15:20:00,1,540.52,457,1,1,2,4,At-Risk
12820,2011-12-06 15:12:00,11,2689.52,2,4,4,4,12,High-Value
12821,2011-05-09 15:51:00,2,220.8,213,2,2,1,5,Other
12822,2011-09-30 10:04:00,2,948.88,69,3,2,3,8,Other
12823,2011-09-26 07:35:00,18,6501.5,73,3,4,4,11,High-Value
12824,2011-10-11 12:49:00,1,397.12,58,3,1,2,6,Other
12825,2010-07-06 13:56:00,2,518.63,520,1,2,2,5,At-Risk
12826,2011-12-07 10:25:00,12,2800.75,1,4,4,4,12,High-Value
12827,2011-12-04 12:17:00,3,430.15,4,4,2,2,8,Other
12828,2011-12-07 08:45:00,6,1018.71,1,4,3,3,10,High-Value
12829,2011-01-07 11:13:00,3,385.3,335,2,2,2,6,Other
12830,2011-11-02 11:54:00,6,6814.64,36,3,3,4,10,High-Value
12831,2011-03-22 13:02:00,3,451.11,261,2,2,2,6,Other
12832,2011-11-07 13:30:00,2,383.03,31,3,2,2,7,Other
12833,2011-07-17 13:46:00,1,417.38,144,2,1,2,5,Other
12834,2011-03-02 09:49:00,1,312.38,281,2,1,1,4,One-Time
12835,2010-10-08 10:59:00,41,5996.83,426,1,4,4,9,High-Value
12836,2011-10-11 15:10:00,15,6559.73,58,3,4,4,11,High-Value
12837,2011-06-19 16:07:00,2,662.66,172,2,2,2,6,Other
12838,2011-11-06 12:20:00,10,2975.91,32,3,4,4,11,High-Value
12839,2011-12-07 12:33:00,26,9669.12,1,4,4,4,12,High-Value
12840,2011-07-19 09:29:00,7,4041.97,142,2,3,4,9,High-Value
12841,2011-12-05 11:13:00,40,6958.2,3,4,4,4,12,High-Value
12842,2011-09-30 15:33:00,4,1917.99,69,3,3,3,9,High-Value
12843,2011-10-05 12:09:00,28,6461.87,64,3,4,4,11,High-Value
12844,2011-11-10 13:31:00,4,648.6,28,3,3,2,8,Loyal
12845,2011-03-17 13:34:00,4,354.09,266,2,3,2,7,Other
12847,2011-11-17 13:16:00,2,1609.0,21,4,2,3,9,High-Value
12848,2010-02-02 12:45:00,1,208.0,674,1,1,1,3,At-Risk
12849,2011-11-08 13:41:00,6,3015.98,30,3,3,4,10,High-Value
12850,2010-09-20 12:26:00,1,330.0,444,1,1,1,3,At-Risk
12851,2011-09-04 12:41:00,2,280.76,95,2,2,1,5,Other
12852,2011-02-18 08:47:00,1,311.55,293,2,1,1,4,One-Time
12853,2011-07-28 11:29:00,11,3907.5,133,2,4,4,10,High-Value
12854,2011-09-22 12:15:00,7,2970.97,77,3,3,4,10,High-Value
12855,2010-12-02 09:37:00,4,612.84,371,2,3,2,7,Other
12856,2011-12-02 10:52:00,6,2170.78,6,4,3,3,10,High-Value
12857,2011-05-13 10:20:00,6,3688.0,209,2,3,4,9,High-Value
12858,2010-11-21 12:55:00,1,147.27,382,1,1,1,3,At-Risk
12859,2010-09-07 12:20:00,1,575.1,457,1,1,2,4,At-Risk
12860,2010-01-15 15:22:00,1,54.22,692,1,1,1,3,At-Risk
12861,2010-03-30 11:39:00,1,68.25,618,1,1,1,3,At-Risk
12862,2010-10-10 11:47:00,2,984.62,424,1,2,3,6,At-Risk
12863,2011-10-18 14:15:00,6,2792.55,51,3,3,4,10,High-Value
12864,2011-07-24 13:03:00,2,299.57,137,2,2,1,5,Other
12865,2011-11-13 14:31:00,4,3323.47,25,3,3,4,10,High-Value
12866,2011-03-01 14:11:00,3,1092.35,282,2,2,3,7,Other
12867,2011-11-13 15:30:00,13,7829.26,25,3,4,4,11,High-Value
12868,2011-06-07 10:42:00,8,2043.76,184,2,4,3,9,High-Value
12869,2010-01-27 12:10:00,1,337.67,680,1,1,1,3,At-Risk
12870,2010-11-29 13:42:00,3,1676.95,374,2,2,3,7,Other
12871,2011-09-16 15:07:00,3,744.02,83,3,2,2,7,Other
12872,2011-01-17 10:52:00,12,3283.96,325,2,4,4,10,High-Value
12873,2011-03-02 14:58:00,3,2027.3,281,2,2,3,7,Other
12874,2010-11-19 15:23:00,2,873.42,384,1,2,3,6,At-Risk
12875,2011-07-19 15:30:00,5,1356.99,142,2,3,3,8,Other
12876,2011-10-13 12:26:00,4,3751.79,56,3,3,4,10,High-Value
12877,2011-12-06 10:30:00,20,2942.14,2,4,4,4,12,High-Value
12878,2011-04-17 13:07:00,2,854.99,235,2,2,2,6,Other
12879,2011-10-26 12:24:00,3,573.22,43,3,2,2,7,Other
12880,2010-11-23 10:50:00,2,640.13,380,1,2,2,5,At-Risk
12881,2011-03-09 11:44:00,1,298.0,274,2,1,1,4,One-Time
12882,2011-11-30 16:18:00,2,1463.04,8,4,2,3,9,High-Value
12883,2011-11-15 09:32:00,4,703.47,23,4,3,2,9,High-Value
12884,2011-09-12 13:10:00,1,309.05,87,3,1,1,5,One-Time
12885,2011-10-07 13:40:00,3,1175.22,62,3,2,3,8,Other
12886,2011-10-03 10:09:00,2,1378.4,66,3,2,3,8,Other
12887,2010-11-21 11:18:00,1,222.4,382,1,1,1,3,At-Risk
12888,2011-05-09 16:02:00,2,354.12,213,2,2,2,6,Other
12889,2010-11-23 16:08:00,4,385.46,380,1,3,2,6,At-Risk
12890,2011-11-15 17:26:00,2,706.02,23,4,2,2,8,Other
12891,2011-06-07 12:31:00,11,840.5,184,2,4,2,8,Other
12892,2010-11-08 09:51:00,1,263.38,395,1,1,1,3,At-Risk
12893,2011-11-09 12:34:00,1,176.55,29,3,1,1,5,One-Time
12894,2010-05-13 14:47:00,1,157.35,574,1,1,1,3,At-Risk
12895,2011-10-28 13:51:00,2,372.8,41,3,2,2,7,Other
12897,2011-05-19 12:13:00,4,514.25,203,2,3,2,7,Other
12898,2010-09-02 08:08:00,2,296.21,462,1,2,1,4,At-Risk
12899,2010-10-22 09:53:00,1,366.4,412,1,1,2,4,At-Risk
12900,2010-10-13 15:17:00,1,340.33,421,1,1,2,4,At-Risk
12901,2011-12-01 10:07:00,28,17654.54,7,4,4,4,12,High-Value
12902,2011-03-20 12:06:00,1,138.68,263,2,1,1,4,One-Time
12903,2010-10-07 12:39:00,1,833.53,427,1,1,2,4,At-Risk
12904,2011-11-21 14:34:00,2,496.06,17,4,2,2,8,Other
12905,2010-05-12 10:05:00,2,1018.42,575,1,2,3,6,At-Risk
12906,2011-11-28 09:55:00,5,2919.81,10,4,3,4,11,High-Value
12907,2010-11-09 12:08:00,2,508.91,394,1,2,2,5,At-Risk
12908,2011-06-16 15:39:00,5,1776.0,175,2,3,3,8,Other
12909,2011-10-31 12:43:00,8,3103.19,38,3,4,4,11,High-Value
12910,2011-11-16 14:28:00,13,5796.52,22,4,4,4,12,High-Value
12911,2010-06-06 12:13:00,1,1651.72,550,1,1,3,5,At-Risk
12912,2011-12-07 08:55:00,5,1662.3,1,4,3,3,10,High-Value
12913,2011-12-05 12:11:00,13,6283.24,3,4,4,4,12,High-Value
12914,2010-11-04 12:28:00,1,223.98,399,1,1,1,3,At-Risk
12915,2011-07-14 11:34:00,4,975.1,147,2,3,3,8,Other
12916,2011-07-24 10:35:00,7,4479.73,137,2,3,4,9,High-Value
12917,2011-08-03 16:42:00,6,4359.2,127,2,3,4,9,High-Value
12919,2011-12-01 13:47:00,6,1335.19,7,4,3,3,10,High-Value
12920,2011-11-22 15:05:00,4,486.64,16,4,3,2,9,High-Value
12921,2011-11-30 16:22:00,74,35233.24,8,4,4,4,12,High-Value
12922,2011-07-01 15:35:00,1,405.38,160,2,1,2,5,Other
12923,2011-10-06 16:20:00,3,769.17,63,3,2,2,7,Other
12924,2011-09-12 13:55:00,12,2461.45,87,3,4,4,11,High-Value
12925,2011-12-05 11:11:00,3,729.33,3,4,2,2,8,Other
12926,2010-10-24 15:57:00,4,1523.59,410,1,3,3,7,At-Risk
12927,2010-11-10 10:02:00,1,197.31,393,1,1,1,3,At-Risk
12928,2011-11-04 14:24:00,12,4304.89,34,3,4,4,11,High-Value
12929,2011-02-01 12:08:00,1,117.85,310,2,1,1,4,One-Time
12930,2011-09-22 15:18:00,2,415.8,77,3,2,2,7,Other
12931,2011-11-18 12:39:00,57,92347.34,20,4,4,4,12,High-Value
12932,2010-06-18 14:22:00,8,1698.56,538,1,4,3,8,At-Risk
12933,2011-11-15 16:38:00,8,1636.63,23,4,4,3,11,High-Value
12934,2009-12-03 10:51:00,1,181.65,735,1,1,1,3,At-Risk
12935,2011-12-07 17:25:00,15,4243.86,1,4,4,4,12,High-Value
12936,2011-11-22 17:32:00,4,1063.9,16,4,3,3,10,High-Value
12937,2011-11-24 15:05:00,9,3097.61,14,4,4,4,12,High-Value
12938,2011-11-14 11:21:00,1,114.14,24,4,1,1,6,One-Time
12939,2011-10-06 14:33:00,20,25264.8,63,3,4,4,11,High-Value
12940,2011-10-16 12:09:00,2,899.69,53,3,2,3,8,Other
12941,2009-12-15 13:12:00,1,377.49,723,1,1,2,4,At-Risk
12942,2011-07-31 14:39:00,3,675.6,130,2,2,2,6,Other
12943,2010-05-30 13:52:00,2,496.5,557,1,2,2,5,At-Risk
12944,2011-11-04 11:04:00,2,604.51,34,3,2,2,7,Other
12945,2011-02-24 14:15:00,2,900.11,287,2,2,3,7,Other
12946,2010-09-29 10:14:00,1,324.45,435,1,1,1,3,At-Risk
12947,2011-07-19 10:06:00,6,1603.99,142,2,3,3,8,Other
12948,2011-11-23 17:10:00,9,2317.43,15,4,4,4,12,High-Value
12949,2011-11-09 11:25:00,22,15526.7,29,3,4,4,11,High-Value
12950,2011-12-07 13:17:00,3,1843.0,1,4,2,3,9,High-Value
12951,2011-12-01 12:14:00,15,3213.72,7,4,4,4,12,High-Value
12952,2011-12-04 10:35:00,4,1387.79,4,4,3,3,10,High-Value
12953,2011-11-30 09:24:00,2,828.81,8,4,2,2,8,Other
12954,2010-03-11 10:16:00,1,162.45,637,1,1,1,3,At-Risk
12955,2011-12-08 16:29:00,11,4757.16,0,4,4,4,12,High-Value
12956,2011-02-06 16:08:00,4,521.89,305,2,3,2,7,Other
12957,2011-11-30 09:53:00,13,8706.97,8,4,4,4,12,High-Value
12958,2010-11-04 16:16:00,2,467.34,399,1,2,2,5,At-Risk
12959,2010-08-12 17:20:00,1,150.95,483,1,1,1,3,At-Risk
12960,2010-10-22 09:31:00,4,1322.07,412,1,3,3,7,At-Risk
12961,2010-11-25 16:44:00,1,211.99,378,2,1,1,4,One-Time
12962,2011-12-02 15:55:00,2,266.39,6,4,2,1,7,Other
12963,2011-12-01 12:55:00,12,3235.79,7,4,4,4,12,High-Value
12964,2010-09-28 17:47:00,1,132.24,436,1,1,1,3,At-Risk
12965,2011-09-11 15:31:00,1,769.81,88,3,1,2,6,Other
12966,2011-11-30 12:38:00,1,160.18,8,4,1,1,6,One-Time
12967,2010-12-16 19:10:00,3,2938.52,357,2,2,4,8,Other
12968,2011-08-19 15:44:00,1,135.95,111,2,1,1,4,One-Time
12969,2010-04-16 10:50:00,1,122.45,601,1,1,1,3,At-Risk
12970,2011-12-02 14:30:00,10,1452.54,6,4,4,3,11,High-Value
12971,2011-12-06 12:20:00,116,15704.6,2,4,4,4,12,High-Value
12972,2010-10-22 08:41:00,4,1161.2,412,1,3,3,7,At-Risk
12973,2010-10-22 10:14:00,1,385.55,412,1,1,2,4,At-Risk
12974,2011-05-26 09:33:00,2,408.95,196,2,2,2,6,Other
12975,2010-09-29 09:46:00,6,2100.09,435,1,3,3,7,At-Risk
12976,2011-05-12 09:55:00,8,3156.38,210,2,4,4,10,High-Value
12977,2011-07-06 16:40:00,4,513.88,155,2,3,2,7,Other
12978,2010-11-19 14:29:00,5,2502.82,384,1,3,4,8,At-Risk
12979,2009-12-10 15:45:00,1,517.7,728,1,1,2,4,At-Risk
12980,2011-07-05 09:34:00,21,16245.78,156,2,4,4,10,High-Value
12981,2011-11-10 12:00:00,2,372.22,28,3,2,2,7,Other
12982,2011-04-11 11:51:00,8,2744.81,241,2,4,4,10,High-Value
12983,2010-04-20 12:58:00,1,490.08,597,1,1,2,4,At-Risk
12984,2011-11-21 12:37:00,1,97.5,17,4,1,1,6,One-Time
12985,2011-12-09 10:46:00,2,1239.38,-1,4,2,3,9,High-Value
12986,2010-10-07 11:57:00,10,2729.84,427,1,4,4,9,High-Value
12987,2011-09-27 12:03:00,5,1312.21,72,3,3,3,9,High-Value
12988,2011-02-20 14:31:00,1,505.82,291,2,1,2,5,Other
12989,2011-12-06 15:28:00,33,13551.75,2,4,4,4,12,High-Value
12990,2011-11-08 13:01:00,7,955.5,30,3,3,3,9,High-Value
12991,2011-11-16 15:34:00,3,764.82,22,4,2,2,8,Other
12992,2009-12-14 16:46:00,1,93.35,724,1,1,1,3,At-Risk
12993,2011-11-16 15:49:00,8,1259.63,22,4,4,3,11,High-Value
12994,2011-12-05 15:43:00,3,974.42,3,4,2,3,9,High-Value
12995,2011-09-15 15:44:00,1,211.32,84,3,1,1,5,One-Time
12996,2010-11-29 09:27:00,1,355.5,374,2,1,2,5,Other
12997,2011-11-17 15:47:00,8,2110.91,21,4,4,3,11,High-Value
12998,2010-08-04 08:05:00,3,920.08,491,1,2,3,6,At-Risk
12999,2011-05-27 13:24:00,3,455.88,195,2,2,2,6,Other
13000,2011-08-25 10:43:00,4,1032.5,105,2,3,3,8,Other
13001,2011-12-05 14:51:00,33,24042.65,3,4,4,4,12,High-Value
13002,2011-01-25 15:18:00,3,414.13,317,2,2,2,6,Other
13003,2011-08-26 10:50:00,3,149.05,104,2,2,1,5,Other
13004,2011-11-28 11:27:00,36,11650.85,10,4,4,4,12,High-Value
13005,2011-06-19 10:53:00,4,999.68,172,2,3,3,8,Other
13006,2011-10-14 13:49:00,1,81.57,55,3,1,1,5,One-Time
13007,2010-05-09 10:38:00,1,175.25,578,1,1,1,3,At-Risk
13008,2011-01-20 14:24:00,3,612.13,322,2,2,2,6,Other
13009,2010-02-05 12:22:00,1,234.0,671,1,1,1,3,At-Risk
13010,2010-11-30 15:09:00,2,330.12,373,2,2,1,5,Other
13011,2010-12-02 17:22:00,1,50.55,371,2,1,1,4,One-Time
13012,2011-11-30 13:05:00,11,2957.83,8,4,4,4,12,High-Value
13013,2011-12-08 15:01:00,29,11097.43,0,4,4,4,12,High-Value
13014,2011-11-29 12:27:00,11,5381.08,9,4,4,4,12,High-Value
13015,2011-10-17 13:19:00,11,6579.78,52,3,4,4,11,High-Value
13016,2011-09-27 14:08:00,3,789.89,72,3,2,2,7,Other
13017,2011-12-02 15:53:00,1,204.0,6,4,1,1,6,One-Time
13018,2011-11-23 13:28:00,35,9763.16,15,4,4,4,12,High-Value
13019,2010-11-25 14:56:00,6,1229.95,378,2,3,3,8,Other
13020,2010-05-26 11:12:00,2,618.96,561,1,2,2,5,At-Risk
13021,2011-12-05 16:37:00,17,4887.24,3,4,4,4,12,High-Value
13022,2010-10-06 10:50:00,1,50.3,428,1,1,1,3,At-Risk
13023,2011-10-06 16:27:00,3,1251.03,63,3,2,3,8,Other
13024,2010-08-26 09:42:00,2,555.87,469,1,2,2,5,At-Risk
13025,2009-12-08 10:02:00,1,323.39,730,1,1,1,3,At-Risk
13026,2011-12-08 16:58:00,9,1733.08,0,4,4,3,11,High-Value
13027,2011-08-18 09:39:00,19,17239.2,112,2,4,4,10,High-Value
13028,2011-11-17 11:10:00,2,661.32,21,4,2,2,8,Other
13029,2011-11-09 09:13:00,5,1927.3,29,3,3,3,9,High-Value
13030,2011-11-28 14:30:00,2,752.44,10,4,2,2,8,Other
13031,2010-10-28 15:34:00,5,3292.84,406,1,3,4,8,At-Risk
13032,2011-10-18 15:54:00,9,2815.96,51,3,4,4,11,High-Value
13033,2010-12-17 14:23:00,2,220.55,356,2,2,1,5,Other
13034,2011-10-16 12:21:00,3,756.82,53,3,2,2,7,Other
13035,2011-09-27 08:57:00,3,1364.2,72,3,2,3,8,Other
13036,2010-01-24 11:35:00,1,307.1,683,1,1,1,3,At-Risk
13037,2011-07-24 15:46:00,12,3914.95,137,2,4,4,10,High-Value
13038,2011-09-20 14:37:00,3,908.46,79,3,2,3,8,Other
13039,2010-05-04 16:45:00,4,1010.73,583,1,3,3,7,At-Risk
13040,2011-12-01 10:38:00,2,676.99,7,4,2,2,8,Other
13041,2010-09-15 11:44:00,4,799.13,449,1,3,2,6,At-Risk
13042,2010-04-20 13:43:00,3,1488.59,597,1,2,3,6,At-Risk
13043,2011-03-11 14:52:00,1,516.42,272,2,1,2,5,Other
13044,2011-02-21 15:20:00,11,4848.05,290,2,4,4,10,High-Value
13045,2011-09-01 15:04:00,3,808.92,98,2,2,2,6,Other
13046,2011-11-09 08:36:00,3,949.25,29,3,2,3,8,Other
13047,2011-10-14 11:15:00,23,8423.58,55,3,4,4,11,High-Value
13048,2011-11-25 13:23:00,9,4049.13,13,4,4,4,12,High-Value
13049,2011-10-06 15:31:00,4,1408.24,63,3,3,3,9,High-Value
13050,2011-11-25 09:18:00,34,11877.29,13,4,4,4,12,High-Value
13051,2010-05-10 09:14:00,2,155.8,577,1,2,1,4,At-Risk
13052,2011-05-11 14:12:00,7,3118.48,211,2,3,4,9,High-Value
13053,2010-03-28 11:28:00,1,127.65,620,1,1,1,3,At-Risk
13055,2011-09-22 14:26:00,4,2321.11,77,3,3,4,10,High-Value
13056,2010-06-06 14:10:00,1,209.48,550,1,1,1,3,At-Risk
13057,2010-06-27 15:44:00,3,709.59,529,1,2,2,5,At-Risk
13058,2011-11-15 12:43:00,3,271.4,23,4,2,1,7,Other
13059,2011-04-04 10:40:00,10,2291.77,248,2,4,4,10,High-Value
13060,2011-03-31 11:37:00,1,307.53,252,2,1,1,4,One-Time
13061,2011-09-28 16:04:00,1,248.61,71,3,1,1,5,One-Time
13062,2011-06-01 15:12:00,1,346.98,190,2,1,2,5,Other
13063,2010-08-16 12:27:00,1,188.4,479,1,1,1,3,At-Risk
13064,2011-11-27 12:31:00,6,1666.84,11,4,3,3,10,High-Value
13065,2010-12-01 16:52:00,5,1055.05,372,2,3,3,8,Other
13066,2011-11-15 12:57:00,2,470.8,23,4,2,2,8,Other
13067,2011-09-18 13:38:00,3,508.51,81,3,2,2,7,Other
13068,2011-11-29 15:00:00,2,344.0,9,4,2,2,8,Other
13069,2011-12-09 08:39:00,38,9284.45,-1,4,4,4,12,High-Value
13070,2011-05-31 13:45:00,4,751.7,191,2,3,2,7,Other
13071,2010-04-06 13:37:00,1,129.22,611,1,1,1,3,At-Risk
13072,2011-03-18 08:12:00,1,177.15,265,2,1,1,4,One-Time
13073,2010-10-24 14:06:00,2,418.08,410,1,2,2,5,At-Risk
13074,2010-07-16 16:53:00,4,1378.74,510,1,3,3,7,At-Risk
13075,2011-08-02 10:19:00,1,919.61,128,2,1,3,6,Other
13076,2010-09-08 10:27:00,1,135.4,456,1,1,1,3,At-Risk
13077,2011-12-08 19:24:00,11,2740.65,0,4,4,4,12,High-Value
13078,2011-12-06 15:36:00,57,29018.06,2,4,4,4,12,High-Value
13079,2011-12-05 16:53:00,6,419.18,3,4,3,2,9,High-Value
13080,2011-06-13 14:59:00,4,280.73,178,2,3,1,6,Other
13081,2011-11-28 10:54:00,28,56838.37,10,4,4,4,12,High-Value
13082,2011-08-05 16:16:00,21,7335.75,125,2,4,4,10,High-Value
13083,2011-12-05 15:01:00,3,395.43,3,4,2,2,8,Other
13084,2010-08-05 08:49:00,1,122.4,490,1,1,1,3,At-Risk
13085,2011-07-05 12:11:00,8,2433.28,156,2,4,4,10,High-Value
13086,2010-11-22 10:28:00,1,439.33,381,1,1,2,4,At-Risk
13087,2009-12-13 15:16:00,1,313.64,725,1,1,1,3,At-Risk
13088,2010-10-18 15:35:00,1,236.11,416,1,1,1,3,At-Risk
13089,2011-12-07 09:02:00,203,113416.91,1,4,4,4,12,High-Value
13090,2011-12-01 12:39:00,23,13076.74,7,4,4,4,12,High-Value
13091,2011-11-11 15:54:00,2,1108.8,27,3,2,3,8,Other
13092,2011-09-30 11:18:00,12,2140.28,69,3,4,3,10,High-Value
13093,2011-03-09 12:14:00,55,54144.25,274,2,4,4,10,High-Value
13094,2011-11-18 14:07:00,13,2209.44,20,4,4,3,11,High-Value
13095,2011-09-30 12:03:00,1,74.4,69,3,1,1,5,One-Time
13096,2010-11-10 14:08:00,1,419.7,393,1,1,2,4,At-Risk
13097,2011-11-07 10:43:00,27,13015.36,31,3,4,4,11,High-Value
13098,2011-12-08 14:14:00,28,28882.44,0,4,4,4,12,High-Value
13099,2011-09-01 17:40:00,1,207.36,98,2,1,1,4,One-Time
13101,2011-04-19 14:37:00,4,695.4,233,2,3,2,7,Other
13102,2011-12-08 12:52:00,37,11380.1,0,4,4,4,12,High-Value
13103,2011-10-31 09:38:00,3,709.64,38,3,2,2,7,Other
13104,2011-12-06 13:10:00,9,1709.1,2,4,4,3,11,High-Value
13105,2010-09-29 13:41:00,1,72.0,435,1,1,1,3,At-Risk
13106,2011-07-29 15:12:00,2,603.46,132,2,2,2,6,Other
13107,2011-10-26 14:52:00,9,5253.07,43,3,4,4,11,High-Value
13108,2010-12-02 10:35:00,2,748.46,371,2,2,2,6,Other
13109,2011-10-11 10:16:00,3,1134.03,58,3,2,3,8,Other
13110,2011-11-08 14:30:00,12,2957.47,30,3,4,4,11,High-Value
13111,2009-12-21 09:00:00,1,321.88,717,1,1,1,3,At-Risk
13112,2010-06-16 17:03:00,1,20.6,540,1,1,1,3,At-Risk
13113,2011-12-09 12:49:00,37,18230.07,-1,4,4,4,12,High-Value
13114,2009-12-09 09:56:00,1,234.38,729,1,1,1,3,At-Risk
13115,2011-11-28 12:38:00,10,5494.7,10,4,4,4,12,High-Value
13116,2011-07-24 14:33:00,1,501.14,137,2,1,2,5,Other
13117,2011-11-18 12:02:00,18,2255.66,20,4,4,4,12,High-Value
13118,2011-11-20 12:46:00,9,2415.41,18,4,4,4,12,High-Value
13119,2010-02-09 08:38:00,1,134.9,667,1,1,1,3,At-Risk
13120,2011-04-15 10:19:00,1,30.6,237,2,1,1,4,One-Time
13121,2011-03-15 16:47:00,1,283.73,268,2,1,1,4,One-Time
13122,2011-09-06 15:53:00,2,922.39,93,3,2,3,8,Other
13123,2010-08-24 10:18:00,2,506.75,471,1,2,2,5,At-Risk
13124,2011-09-11 12:45:00,4,4641.66,88,3,3,4,10,High-Value
13125,2010-07-04 11:58:00,1,148.62,522,1,1,1,3,At-Risk
13126,2011-12-05 10:00:00,13,3774.81,3,4,4,4,12,High-Value
13127,2011-09-23 10:26:00,1,259.17,76,3,1,1,5,One-Time
13128,2010-03-18 15:08:00,1,263.5,630,1,1,1,3,At-Risk
13129,2010-09-13 13:47:00,2,233.25,451,1,2,1,4,At-Risk
13130,2011-09-06 15:30:00,1,64.0,93,3,1,1,5,One-Time
13131,2011-11-16 13:21:00,7,3313.77,22,4,3,4,11,High-Value
13132,2011-03-23 12:44:00,1,77.3,260,2,1,1,4,One-Time
13133,2011-03-11 10:31:00,3,200.45,272,2,2,1,5,Other
13134,2011-09-15 10:35:00,6,2475.23,84,3,3,4,10,High-Value
13135,2011-05-27 10:52:00,2,3371.45,195,2,2,4,8,Other
13136,2011-10-14 13:41:00,13,6274.56,55,3,4,4,11,High-Value
13137,2011-11-29 12:09:00,16,7586.94,9,4,4,4,12,High-Value
13138,2011-11-17 16:51:00,7,1274.01,21,4,3,3,10,High-Value
13139,2011-11-23 13:54:00,8,8202.98,15,4,4,4,12,High-Value
13140,2011-08-23 15:33:00,5,1054.92,107,2,3,3,8,Other
13141,2011-09-16 09:54:00,17,7656.08,83,3,4,4,11,High-Value
13142,2011-11-20 16:07:00,1,307.09,18,4,1,1,6,One-Time
13143,2010-05-04 12:22:00,1,405.1,583,1,1,2,4,At-Risk
13144,2011-01-11 11:15:00,2,135.35,331,2,2,1,5,Other
13145,2011-10-31 12:45:00,7,1128.52,38,3,3,3,9,High-Value
13146,2011-11-13 15:29:00,1,228.91,25,3,1,1,5,One-Time
13147,2011-11-29 13:59:00,4,712.8,9,4,3,2,9,High-Value
13148,2011-11-10 15:23:00,26,8488.32,28,3,4,4,11,High-Value
13149,2011-11-25 13:09:00,4,1676.06,13,4,3,3,10,High-Value
13150,2010-08-12 12:59:00,3,449.97,483,1,2,2,5,At-Risk
13151,2011-02-17 12:29:00,3,2454.71,294,2,2,4,8,Other
13152,2010-10-18 13:44:00,7,2146.38,416,1,3,3,7,At-Risk
13153,2011-12-04 12:14:00,1,486.22,4,4,1,2,7,Other
13154,2010-11-05 16:00:00,3,1624.84,398,1,2,3,6,At-Risk
13155,2011-11-06 15:41:00,6,1370.48,32,3,3,3,9,High-Value
13156,2010-11-19 13:09:00,3,1586.54,384,1,2,3,6,At-Risk
13157,2011-10-21 13:50:00,9,5687.36,48,3,4,4,11,High-Value
13158,2011-09-06 11:58:00,5,1508.18,93,3,3,3,9,High-Value
13159,2011-12-01 11:20:00,4,1429.35,7,4,3,3,10,High-Value
13160,2011-11-17 13:07:00,1,91.8,21,4,1,1,6,One-Time
13161,2011-01-30 14:03:00,2,472.13,312,2,2,2,6,Other
13162,2011-08-09 15:59:00,16,9275.49,121,2,4,4,10,High-Value
13163,2010-04-08 16:21:00,1,17.65,609,1,1,1,3,At-Risk
13164,2010-05-19 13:52:00,2,372.2,568,1,2,2,5,At-Risk
13165,2011-10-24 15:05:00,3,1451.16,45,3,2,3,8,Other
13166,2011-03-01 15:16:00,2,875.93,282,2,2,3,7,Other
13167,2011-11-21 12:24:00,5,1113.15,17,4,3,3,10,High-Value
13168,2011-11-03 12:56:00,5,1840.73,35,3,3,3,9,High-Value
13169,2011-10-07 12:11:00,3,840.08,62,3,2,2,7,Other
13170,2011-11-13 12:19:00,1,108.81,25,3,1,1,5,One-Time
13171,2011-11-18 10:27:00,3,468.41,20,4,2,2,8,Other
13172,2010-11-04 15:10:00,1,69.6,399,1,1,1,3,At-Risk
13173,2011-12-05 15:51:00,11,2389.82,3,4,4,4,12,High-Value
13174,2011-11-23 14:35:00,11,7972.46,15,4,4,4,12,High-Value
13175,2010-05-06 13:13:00,2,831.45,581,1,2,2,5,At-Risk
13176,2011-10-24 15:43:00,1,481.49,45,3,1,2,6,Other
13177,2011-10-06 09:56:00,2,512.2,63,3,2,2,7,Other
13178,2011-11-13 16:14:00,21,14059.19,25,3,4,4,11,High-Value
13179,2010-03-31 11:40:00,1,572.31,617,1,1,2,4,At-Risk
13180,2010-04-11 13:37:00,1,86.1,606,1,1,1,3,At-Risk
13181,2010-11-23 15:05:00,1,359.69,380,1,1,2,4,At-Risk
13182,2011-10-25 13:46:00,1,121.18,44,3,1,1,5,One-Time
13183,2011-12-02 10:30:00,15,7036.18,6,4,4,4,12,High-Value
13184,2011-11-25 12:02:00,10,1667.95,13,4,4,3,11,High-Value
13185,2011-03-17 11:56:00,1,71.4,266,2,1,1,4,One-Time
13186,2011-10-31 11:40:00,3,1575.89,38,3,2,3,8,Other
13187,2011-01-06 18:57:00,4,328.36,336,2,3,1,6,Other
13188,2011-11-28 15:28:00,1,114.6,10,4,1,1,6,One-Time
13189,2011-11-21 10:39:00,2,260.68,17,4,2,1,7,Other
13190,2010-06-13 15:47:00,3,570.66,543,1,2,2,5,At-Risk
13191,2010-02-19 17:02:00,1,159.21,657,1,1,1,3,At-Risk
13192,2011-09-05 14:13:00,6,2558.58,94,3,3,4,10,High-Value
13193,2011-10-09 14:30:00,1,112.08,60,3,1,1,5,One-Time
13194,2011-07-27 09:01:00,2,472.78,134,2,2,2,6,Other
13195,2010-10-21 13:07:00,1,136.73,413,1,1,1,3,At-Risk
13196,2011-11-28 13:54:00,7,3068.84,10,4,3,4,11,High-Value
13197,2010-04-09 09:14:00,1,373.01,608,1,1,2,4,At-Risk
13198,2011-11-29 15:17:00,8,4974.23,9,4,4,4,12,High-Value
13199,2011-12-06 12:30:00,66,15949.21,2,4,4,4,12,High-Value
13200,2011-11-20 15:35:00,4,870.09,18,4,3,3,10,High-Value
13201,2010-07-25 14:30:00,4,1233.06,501,1,3,3,7,At-Risk
13202,2010-11-10 16:24:00,7,1580.3,393,1,3,3,7,At-Risk
13203,2011-11-30 10:45:00,10,2648.25,8,4,4,4,12,High-Value
13204,2009-12-08 14:56:00,1,966.66,730,1,1,3,5,At-Risk
13205,2010-09-22 16:26:00,1,2803.2,442,1,1,4,6,At-Risk
13206,2010-11-04 16:50:00,13,8308.19,399,1,4,4,9,High-Value
13207,2011-11-24 14:52:00,4,535.86,14,4,3,2,9,High-Value
13208,2011-10-11 16:25:00,8,1951.82,58,3,4,3,10,High-Value
13209,2011-11-09 13:54:00,13,8509.51,29,3,4,4,11,High-Value
13210,2011-09-07 08:18:00,1,353.48,92,3,1,2,6,Other
13211,2011-11-29 14:43:00,10,2618.77,9,4,4,4,12,High-Value
13212,2011-11-20 12:40:00,3,786.83,18,4,2,2,8,Other
13213,2011-10-14 11:42:00,11,3851.52,55,3,4,4,11,High-Value
13214,2010-10-18 10:00:00,7,3264.23,416,1,3,4,8,At-Risk
13215,2010-11-02 18:26:00,1,81.6,401,1,1,1,3,At-Risk
13216,2011-03-17 12:18:00,1,333.74,266,2,1,1,4,One-Time
13217,2011-08-09 15:32:00,4,666.48,121,2,3,2,7,Other
13218,2011-08-04 16:59:00,1,62.64,126,2,1,1,4,One-Time
13219,2010-03-31 14:18:00,1,76.23,617,1,1,1,3,At-Risk
13220,2011-09-22 13:38:00,5,1336.09,77,3,3,3,9,High-Value
13221,2011-04-13 16:58:00,2,844.86,239,2,2,2,6,Other
13222,2010-05-11 13:54:00,1,88.5,576,1,1,1,3,At-Risk
13223,2011-05-23 13:03:00,6,969.12,199,2,3,3,8,Other
13224,2011-10-10 14:55:00,2,2152.95,59,3,2,3,8,Other
13225,2011-12-06 13:29:00,16,16260.07,2,4,4,4,12,High-Value
13226,2011-03-11 14:35:00,2,312.46,272,2,2,1,5,Other
13227,2011-05-22 11:47:00,1,257.7,200,2,1,1,4,One-Time
13228,2011-09-19 14:28:00,1,358.0,80,3,1,2,6,Other
13229,2011-04-28 12:07:00,1,160.95,224,2,1,1,4,One-Time
13230,2011-12-05 16:03:00,30,6109.51,3,4,4,4,12,High-Value
13232,2011-11-27 10:39:00,7,1327.75,11,4,3,3,10,High-Value
13233,2011-09-26 13:25:00,4,1176.46,73,3,3,3,9,High-Value
13234,2010-02-05 11:41:00,2,346.5,671,1,2,2,5,At-Risk
13235,2011-05-11 17:13:00,1,1031.07,211,2,1,3,6,Other
13236,2011-11-15 12:50:00,2,744.85,23,4,2,2,8,Other
13237,2010-11-17 10:07:00,1,643.0,386,1,1,2,4,At-Risk
13238,2011-11-22 15:37:00,6,1006.63,16,4,3,3,10,High-Value
13239,2011-03-23 10:25:00,5,1594.69,260,2,3,3,8,Other
13240,2011-09-04 14:08:00,8,1455.39,95,2,4,3,9,High-Value
13241,2010-10-24 11:17:00,1,112.53,410,1,1,1,3,At-Risk
13242,2011-08-19 12:53:00,7,699.4,111,2,3,2,7,Other
13243,2011-05-20 13:14:00,5,1220.38,202,2,3,3,8,Other
13244,2011-09-08 11:46:00,1,121.74,91,3,1,1,5,One-Time
13245,2011-10-20 11:40:00,2,989.22,49,3,2,3,8,Other
13246,2011-11-21 16:50:00,11,3351.75,17,4,4,4,12,High-Value
13247,2011-11-22 10:59:00,4,501.12,16,4,3,2,9,High-Value
13248,2011-08-07 12:40:00,2,465.68,123,2,2,2,6,Other
13249,2011-09-08 13:26:00,9,1608.93,91,3,4,3,10,High-Value
13250,2010-09-05 11:33:00,2,253.09,459,1,2,1,4,At-Risk
13251,2010-11-02 13:20:00,1,252.68,401,1,1,1,3,At-Risk
13252,2010-11-10 16:00:00,2,399.3,393,1,2,2,5,At-Risk
13253,2011-07-06 10:09:00,4,2951.11,155,2,3,4,9,High-Value
13254,2010-11-28 15:42:00,1,51.41,375,2,1,1,4,One-Time
13255,2011-11-30 13:14:00,3,678.76,8,4,2,2,8,Other
13257,2010-09-29 14:58:00,1,149.75,435,1,1,1,3,At-Risk
13258,2011-11-28 09:31:00,5,1009.43,10,4,3,3,10,High-Value
13259,2011-10-09 10:48:00,9,1398.79,60,3,4,3,10,High-Value
13260,2011-10-09 13:21:00,1,557.62,60,3,1,2,6,Other
13261,2011-03-16 12:22:00,2,944.1,267,2,2,3,7,Other
13262,2011-03-21 15:06:00,3,573.45,262,2,2,2,6,Other
13263,2011-12-08 13:59:00,38,8650.98,0,4,4,4,12,High-Value
13264,2010-09-23 12:42:00,1,722.56,441,1,1,2,4,At-Risk
13265,2011-10-17 15:02:00,5,2092.66,52,3,3,3,9,High-Value
13266,2011-11-28 14:39:00,19,6135.04,10,4,4,4,12,High-Value
13267,2011-12-07 11:12:00,36,9429.81,1,4,4,4,12,High-Value
13268,2011-11-22 11:34:00,10,3152.71,16,4,4,4,12,High-Value
13269,2011-12-08 14:53:00,28,8537.32,0,4,4,4,12,High-Value
13270,2010-12-08 14:53:00,1,590.0,365,2,1,2,5,Other
13271,2011-11-02 14:31:00,1,211.49,36,3,1,1,5,One-Time
13272,2011-11-08 14:00:00,2,276.56,30,3,2,1,6,Other
13273,2011-08-18 14:02:00,1,138.98,112,2,1,1,4,One-Time
13274,2010-10-26 13:48:00,1,360.85,408,1,1,2,4,At-Risk
13275,2010-11-21 12:09:00,2,238.86,382,1,2,1,4,At-Risk
13276,2011-10-07 12:44:00,5,1891.91,62,3,3,3,9,High-Value
13277,2011-11-24 09:21:00,7,523.3,14,4,3,2,9,High-Value
13278,2011-10-30 11:49:00,4,1425.35,39,3,3,3,9,High-Value
13279,2011-09-22 17:24:00,1,137.75,77,3,1,1,5,One-Time
13280,2011-08-09 13:14:00,7,2293.33,121,2,3,4,9,High-Value
13281,2010-09-26 16:03:00,1,350.85,438,1,1,2,4,At-Risk
13282,2011-11-21 15:33:00,4,1313.19,17,4,3,3,10,High-Value
13283,2011-10-11 09:50:00,4,373.36,58,3,3,2,8,Loyal
13284,2011-01-13 09:23:00,1,201.19,329,2,1,1,4,One-Time
13285,2011-11-16 13:19:00,6,3364.59,22,4,3,4,11,High-Value
13286,2010-04-18 15:35:00,1,734.91,599,1,1,2,4,At-Risk
13287,2010-04-15 15:26:00,3,781.59,602,1,2,2,5,At-Risk
13288,2010-09-22 16:32:00,5,927.61,442,1,3,3,7,At-Risk
13289,2009-12-16 11:53:00,1,307.95,722,1,1,1,3,At-Risk
13291,2011-07-07 10:36:00,11,3270.79,154,2,4,4,10,High-Value
13292,2011-11-01 10:04:00,5,994.51,37,3,3,3,9,High-Value
13293,2010-11-12 13:28:00,6,1192.94,391,1,3,3,7,At-Risk
13294,2011-06-03 08:54:00,3,1689.53,188,2,2,3,7,Other
13295,2010-12-15 11:21:00,4,1101.97,358,2,3,3,8,Other
13296,2011-07-25 13:46:00,6,792.51,136,2,3,2,7,Other
13297,2011-12-02 09:32:00,7,4368.62,6,4,3,4,11,High-Value
13298,2011-12-08 13:11:00,1,360.0,0,4,1,2,7,Other
13299,2011-03-16 12:55:00,3,1218.7,267,2,2,3,7,Other
13300,2011-06-23 13:09:00,3,1285.51,168,2,2,3,7,Other
13301,2011-08-28 11:25:00,4,600.19,102,2,3,2,7,Other
13302,2011-07-07 17:56:00,2,159.2,154,2,2,1,5,Other
13303,2010-11-04 14:55:00,1,61.72,399,1,1,1,3,At-Risk
13304,2010-12-23 14:35:00,4,1217.99,350,2,3,3,8,Other
13305,2011-12-05 15:15:00,16,3616.41,3,4,4,4,12,High-Value
13306,2010-10-05 14:55:00,1,53.65,429,1,1,1,3,At-Risk
13307,2011-08-11 17:14:00,3,273.34,119,2,2,1,5,Other
13308,2011-11-17 09:31:00,4,1670.37,21,4,3,3,10,High-Value
13309,2011-12-02 16:34:00,6,1706.37,6,4,3,3,10,High-Value
13310,2011-11-11 17:23:00,5,1541.2,27,3,3,3,9,High-Value
13311,2011-12-05 12:55:00,2,598.57,3,4,2,2,8,Other
13312,2010-09-14 14:36:00,1,124.75,450,1,1,1,3,At-Risk
13313,2011-11-17 16:48:00,12,3445.32,21,4,4,4,12,High-Value
13314,2011-12-08 12:29:00,3,775.94,0,4,2,2,8,Other
13315,2010-01-19 15:34:00,1,310.26,688,1,1,1,3,At-Risk
13316,2011-11-02 13:40:00,10,12940.82,36,3,4,4,11,High-Value
13317,2011-10-04 13:35:00,19,6486.09,65,3,4,4,11,High-Value
13318,2011-12-08 18:51:00,3,640.76,0,4,2,2,8,Other
13319,2011-12-04 13:34:00,58,21323.22,4,4,4,4,12,High-Value
13320,2011-09-22 18:07:00,6,2211.6,77,3,3,3,9,High-Value
13321,2011-09-28 15:24:00,2,567.36,71,3,2,2,7,Other
13322,2011-11-22 14:21:00,1,199.48,16,4,1,1,6,One-Time
13323,2011-12-06 17:12:00,5,787.85,2,4,3,2,9,High-Value
13324,2011-11-03 16:28:00,18,10513.47,35,3,4,4,11,High-Value
13325,2011-09-19 10:36:00,1,675.3,80,3,1,2,6,Other
13326,2010-10-03 16:00:00,1,281.76,431,1,1,1,3,At-Risk
13327,2011-11-01 10:21:00,19,9052.87,37,3,4,4,11,High-Value
13328,2011-01-27 15:22:00,1,1308.48,315,2,1,3,6,Other
13329,2011-11-08 10:29:00,8,4808.77,30,3,4,4,11,High-Value
13330,2011-09-08 12:27:00,6,2796.1,91,3,3,4,10,High-Value
13331,2010-11-03 08:04:00,1,262.4,400,1,1,1,3,At-Risk
13332,2011-11-25 13:30:00,1,350.9,13,4,1,2,7,Other
13333,2010-10-24 13:24:00,3,1015.74,410,1,2,3,6,At-Risk
13334,2011-09-18 15:21:00,5,6201.8,81,3,3,4,10,High-Value
13336,2011-09-23 14:05:00,1,795.12,76,3,1,2,6,Other
13337,2010-06-11 13:27:00,1,1575.26,545,1,1,3,5,At-Risk
13338,2011-07-05 09:06:00,4,2345.62,156,2,3,4,9,High-Value
13339,2011-05-23 08:31:00,1,860.12,199,2,1,3,6,Other
13340,2011-10-25 13:15:00,12,22100.56,44,3,4,4,11,High-Value
13341,2011-03-24 09:50:00,1,775.85,259,2,1,2,5,Other
13343,2011-06-15 12:24:00,1,303.43,176,2,1,1,4,One-Time
13344,2011-10-03 09:45:00,3,2511.69,66,3,2,4,9,High-Value
13345,2011-02-25 09:01:00,1,339.5,286,2,1,1,4,One-Time
13346,2010-09-03 11:41:00,6,299.4,461,1,3,1,5,At-Risk
13347,2011-09-30 13:28:00,1,291.36,69,3,1,1,5,One-Time
13348,2011-10-06 17:28:00,1,233.76,63,3,1,1,5,One-Time
13349,2011-11-29 08:07:00,1,197.32,9,4,1,1,6,One-Time
13350,2011-11-23 16:33:00,2,879.12,15,4,2,3,9,High-Value
13351,2011-10-04 12:55:00,1,323.94,65,3,1,1,5,One-Time
13352,2011-10-10 13:55:00,1,347.98,59,3,1,2,6,Other
13354,2011-09-29 13:17:00,1,743.53,70,3,1,2,6,Other
13355,2011-08-09 14:48:00,1,674.7,121,2,1,2,5,Other
13356,2011-09-20 14:33:00,1,768.24,79,3,1,2,6,Other
13357,2011-03-27 13:56:00,5,3795.01,256,2,3,4,9,High-Value
13358,2011-03-16 11:52:00,1,389.03,267,2,1,2,5,Other
13359,2011-10-07 09:30:00,2,943.31,62,3,2,3,8,Other
13360,2010-10-04 12:37:00,4,1503.65,430,1,3,3,7,At-Risk
13361,2010-08-24 14:56:00,2,1450.5,471,1,2,3,6,At-Risk
13362,2011-11-30 14:41:00,7,5394.07,8,4,3,4,11,High-Value
13363,2011-11-22 12:40:00,3,1623.86,16,4,2,3,9,High-Value
13364,2011-09-29 18:13:00,1,134.96,70,3,1,1,5,One-Time
13365,2011-11-06 12:36:00,2,2225.37,32,3,2,3,8,Other
13366,2011-10-20 13:37:00,1,56.16,49,3,1,1,5,One-Time
13367,2010-10-04 10:00:00,1,460.2,430,1,1,2,4,At-Risk
13368,2011-03-28 09:59:00,4,1021.5,255,2,3,3,8,Other
13369,2010-12-09 11:30:00,1,258.28,364,2,1,1,4,One-Time
13370,2010-12-03 10:26:00,1,754.87,370,2,1,2,5,Other
13371,2010-07-22 17:33:00,2,2297.66,504,1,2,4,7,At-Risk
13372,2011-09-11 12:46:00,1,328.64,88,3,1,1,5,One-Time
13373,2011-10-10 10:51:00,6,7587.19,59,3,3,4,10,High-Value
13374,2010-10-21 10:04:00,2,372.8,413,1,2,2,5,At-Risk
13375,2011-09-12 10:19:00,2,1792.23,87,3,2,3,8,Other
13376,2011-09-01 16:16:00,3,869.76,98,2,2,3,7,Other
13377,2010-11-08 12:20:00,2,1452.88,395,1,2,3,6,At-Risk
13379,2011-11-13 13:45:00,3,572.56,25,3,2,2,7,Other
13380,2010-10-03 10:18:00,1,62.4,431,1,1,1,3,At-Risk
13381,2011-11-08 11:58:00,12,8224.37,30,3,4,4,11,High-Value
13382,2011-03-04 10:03:00,5,1387.58,279,2,3,3,8,Other
13383,2010-06-14 11:45:00,1,305.28,542,1,1,1,3,At-Risk
13384,2011-11-09 11:04:00,11,6680.83,29,3,4,4,11,High-Value
13385,2011-01-14 09:52:00,1,534.57,328,2,1,2,5,Other
13386,2010-10-21 12:52:00,2,835.46,413,1,2,2,5,At-Risk
13387,2010-10-18 14:07:00,1,181.84,416,1,1,1,3,At-Risk
13388,2011-07-31 12:52:00,3,1185.65,130,2,2,3,7,Other
13389,2011-11-28 14:01:00,3,797.96,10,4,2,2,8,Other
13390,2011-09-26 08:38:00,1,544.08,73,3,1,2,6,Other
13391,2011-05-20 10:50:00,1,59.8,202,2,1,1,4,One-Time
13392,2010-01-31 13:34:00,1,91.14,676,1,1,1,3,At-Risk
13393,2010-05-05 09:34:00,4,1131.45,582,1,3,3,7,At-Risk
13394,2011-12-08 11:36:00,19,6621.7,0,4,4,4,12,High-Value
13395,2011-06-07 15:04:00,3,1180.23,184,2,2,3,7,Other
13396,2011-11-10 16:59:00,2,1360.99,28,3,2,3,8,Other
13397,2011-09-28 10:56:00,10,3191.87,71,3,4,4,11,High-Value
13398,2011-05-31 13:17:00,2,670.34,191,2,2,2,6,Other
13399,2010-09-01 13:59:00,3,275.4,463,1,2,1,4,At-Risk
13400,2010-05-06 09:00:00,1,310.83,581,1,1,1,3,At-Risk
13402,2011-08-04 15:51:00,4,1226.85,126,2,3,3,8,Other
13403,2011-11-22 08:28:00,3,229.5,16,4,2,1,7,Other
13404,2011-12-08 15:37:00,2,252.49,0,4,2,1,7,Other
13405,2011-05-19 16:31:00,5,1198.81,203,2,3,3,8,Other
13406,2010-10-08 14:44:00,2,568.92,426,1,2,2,5,At-Risk
13407,2010-05-10 12:41:00,3,2244.7,577,1,2,4,7,At-Risk
13408,2011-12-08 09:05:00,106,50174.78,0,4,4,4,12,High-Value
13410,2011-11-15 15:33:00,9,2201.96,23,4,4,3,11,High-Value
13411,2011-08-24 13:57:00,1,213.55,106,2,1,1,4,One-Time
13412,2010-03-29 16:28:00,1,487.35,619,1,1,2,4,At-Risk
13413,2010-03-10 12:17:00,6,429.44,638,1,3,2,6,At-Risk
13414,2011-07-29 11:45:00,6,2494.14,132,2,3,4,9,High-Value
13415,2010-08-24 11:38:00,4,784.17,471,1,3,2,6,At-Risk
13416,2011-10-27 08:56:00,3,940.8,42,3,2,3,8,Other
13417,2011-12-05 08:49:00,6,1669.49,3,4,3,3,10,High-Value
13418,2011-11-28 10:23:00,31,11559.66,10,4,4,4,12,High-Value
13419,2011-10-07 12:49:00,1,221.06,62,3,1,1,5,One-Time
13420,2011-07-13 08:48:00,2,159.85,148,2,2,1,5,Other
13421,2011-10-30 14:21:00,8,4048.25,39,3,4,4,11,High-Value
13422,2011-10-06 13:42:00,1,2626.3,63,3,1,4,8,Other
13423,2010-10-07 09:02:00,1,217.03,427,1,1,1,3,At-Risk
13424,2010-09-16 10:49:00,1,572.77,448,1,1,2,4,At-Risk
13425,2011-08-23 17:13:00,5,3390.43,107,2,3,4,9,High-Value
13426,2011-12-09 08:59:00,22,8167.38,-1,4,4,4,12,High-Value
13427,2011-11-20 13:02:00,6,1006.53,18,4,3,3,10,High-Value
13428,2011-11-29 14:20:00,3,478.54,9,4,2,2,8,Other
13429,2011-11-29 09:10:00,4,1006.8,9,4,3,3,10,High-Value
13430,2011-11-21 08:19:00,2,679.45,17,4,2,2,8,Other
13431,2011-10-03 13:49:00,8,3316.24,66,3,4,4,11,High-Value
13432,2010-05-17 13:18:00,2,436.55,570,1,2,2,5,At-Risk
13433,2010-07-26 16:55:00,4,658.32,500,1,3,2,6,At-Risk
13434,2011-09-26 14:30:00,5,1666.86,73,3,3,3,9,High-Value
13435,2011-12-04 14:45:00,9,4447.33,4,4,4,4,12,High-Value
13436,2011-12-08 10:33:00,1,196.89,0,4,1,1,6,One-Time
13437,2011-11-25 14:00:00,7,3408.06,13,4,3,4,11,High-Value
13438,2010-06-10 18:46:00,1,46.5,546,1,1,1,3,At-Risk
13439,2011-03-29 14:20:00,3,986.61,254,2,2,3,7,Other
13440,2010-10-12 13:11:00,7,1295.25,422,1,3,3,7,At-Risk
13441,2011-09-09 09:38:00,2,720.9,90,3,2,2,7,Other
13442,2010-02-10 14:03:00,3,419.87,666,1,2,2,5,At-Risk
13443,2010-09-17 12:31:00,6,1269.37,447,1,3,3,7,At-Risk
13444,2010-11-30 13:02:00,2,619.08,373,2,2,2,6,Other
13445,2010-03-23 15:34:00,1,241.9,625,1,1,1,3,At-Risk
13446,2010-10-05 18:51:00,11,3881.89,429,1,4,4,9,High-Value
13447,2011-11-16 13:38:00,3,1129.14,22,4,2,3,9,High-Value
13448,2011-11-23 12:33:00,12,8386.22,15,4,4,4,12,High-Value
13449,2011-11-16 08:28:00,1,291.88,22,4,1,1,6,One-Time
13450,2011-11-13 11:54:00,13,4120.04,25,3,4,4,11,High-Value
13451,2011-11-13 15:58:00,11,7088.92,25,3,4,4,11,High-Value
13452,2011-03-25 14:19:00,3,729.8,258,2,2,2,6,Other
13453,2011-06-27 09:34:00,3,781.69,164,2,2,2,6,Other
13454,2010-03-08 14:40:00,1,219.87,640,1,1,1,3,At-Risk
13455,2011-11-15 11:21:00,6,2212.99,23,4,3,3,10,High-Value
13456,2011-11-22 09:18:00,6,1766.72,16,4,3,3,10,High-Value
13457,2010-01-20 08:48:00,2,148.22,687,1,2,1,4,At-Risk
13458,2011-12-02 15:29:00,16,11959.27,6,4,4,4,12,High-Value
13459,2010-03-25 10:24:00,2,1160.41,623,1,2,3,6,At-Risk
13460,2011-11-10 17:17:00,2,183.44,28,3,2,1,6,Other
13461,2011-11-01 09:01:00,6,4160.0,37,3,3,4,10,High-Value
13462,2011-04-01 11:20:00,5,1153.85,251,2,3,3,8,Other
13464,2011-10-12 15:01:00,6,3097.64,57,3,3,4,10,High-Value
13465,2010-09-19 15:13:00,2,931.12,445,1,2,3,6,At-Risk
13466,2011-06-08 16:39:00,5,1013.35,183,2,3,3,8,Other
13467,2011-11-29 10:01:00,2,1071.91,9,4,2,3,9,High-Value
13468,2011-12-08 10:39:00,72,12793.28,0,4,4,4,12,High-Value
13469,2010-02-24 15:03:00,1,82.4,652,1,1,1,3,At-Risk
13470,2011-09-01 14:57:00,2,165.0,98,2,2,1,5,Other
13471,2011-12-08 15:44:00,4,2501.84,0,4,3,4,11,High-Value
13472,2010-09-02 09:41:00,2,592.24,462,1,2,2,5,At-Risk
13473,2011-10-10 11:20:00,8,2657.76,59,3,4,4,11,High-Value
13474,2011-04-17 13:53:00,3,646.59,235,2,2,2,6,Other
13475,2011-06-01 13:52:00,4,1431.78,190,2,3,3,8,Other
13476,2011-06-14 12:00:00,5,2061.47,177,2,3,3,8,Other
13477,2011-11-02 12:04:00,11,2819.17,36,3,4,4,11,High-Value
13478,2010-08-27 13:23:00,5,2215.78,468,1,3,3,7,At-Risk
13479,2011-05-23 10:45:00,4,851.37,199,2,3,2,7,Other
13480,2010-10-19 11:53:00,2,627.82,415,1,2,2,5,At-Risk
13481,2011-10-25 09:07:00,11,3830.84,44,3,4,4,11,High-Value
13482,2011-04-21 17:03:00,2,336.09,231,2,2,1,5,Other
13483,2011-10-05 11:53:00,1,140.34,64,3,1,1,5,One-Time
13484,2011-04-12 16:30:00,3,790.72,240,2,2,2,6,Other
13485,2011-04-20 13:58:00,11,3015.22,232,2,4,4,10,High-Value
13486,2011-09-22 13:13:00,3,1122.41,77,3,2,3,8,Other
13487,2011-10-13 12:07:00,5,846.87,56,3,3,2,8,Loyal
13488,2011-11-22 14:41:00,23,14205.96,16,4,4,4,12,High-Value
13489,2011-08-26 13:16:00,4,449.52,104,2,3,2,7,Other
13490,2010-02-23 14:48:00,1,154.25,653,1,1,1,3,At-Risk
13491,2011-10-19 08:32:00,27,4467.66,50,3,4,4,11,High-Value
13492,2011-07-26 14:25:00,3,1269.84,135,2,2,3,7,Other
13493,2011-03-09 15:35:00,2,498.63,274,2,2,2,6,Other
13494,2011-02-01 11:58:00,1,316.26,310,2,1,1,4,One-Time
13495,2011-12-02 11:21:00,10,4863.31,6,4,4,4,12,High-Value
13496,2011-11-29 10:58:00,2,653.33,9,4,2,2,8,Other
13497,2011-03-02 09:04:00,6,1166.83,281,2,3,3,8,Other
13498,2009-12-09 15:26:00,1,327.38,729,1,1,1,3,At-Risk
13499,2011-11-22 11:21:00,5,1159.11,16,4,3,3,10,High-Value
13500,2011-11-16 15:35:00,4,1466.3,22,4,3,3,10,High-Value
13501,2011-02-24 18:59:00,3,2885.11,287,2,2,4,8,Other
13502,2011-11-23 10:39:00,5,780.5,15,4,3,2,9,High-Value
13503,2011-09-29 13:23:00,5,1778.04,70,3,3,3,9,High-Value
13504,2011-10-06 13:20:00,1,295.93,63,3,1,1,5,One-Time
13505,2011-09-28 11:56:00,4,3633.63,71,3,3,4,10,High-Value
13506,2011-01-27 13:53:00,5,1338.08,315,2,3,3,8,Other
13507,2011-12-06 13:13:00,4,2479.16,2,4,3,4,11,High-Value
13508,2011-04-10 11:58:00,2,287.05,242,2,2,1,5,Other
13509,2011-12-01 10:10:00,7,1099.72,7,4,3,3,10,High-Value
13510,2011-12-08 13:46:00,11,4558.29,0,4,4,4,12,High-Value
13511,2010-02-01 12:10:00,1,282.76,675,1,1,1,3,At-Risk
13512,2011-03-24 10:03:00,4,713.39,259,2,3,2,7,Other
13513,2011-08-05 11:50:00,3,824.59,125,2,2,2,6,Other
13514,2011-09-27 09:39:00,4,815.9,72,3,3,2,8,Loyal
13515,2011-09-28 11:26:00,6,1265.82,71,3,3,3,9,High-Value
13516,2011-11-18 13:15:00,4,1685.26,20,4,3,3,10,High-Value
13517,2011-10-11 11:43:00,3,2128.42,58,3,2,3,8,Other
13518,2011-09-15 10:29:00,1,627.16,84,3,1,2,6,Other
13519,2011-09-22 18:24:00,2,343.21,77,3,2,2,7,Other
13520,2011-10-12 10:20:00,11,5446.0,57,3,4,4,11,High-Value
13521,2011-12-08 13:50:00,3,1070.47,0,4,2,3,9,High-Value
13522,2011-11-09 15:11:00,1,125.8,29,3,1,1,5,One-Time
13523,2011-11-06 15:11:00,6,4534.57,32,3,3,4,10,High-Value
13524,2011-10-30 12:34:00,5,680.18,39,3,3,2,8,Loyal
13525,2011-11-25 12:01:00,2,628.78,13,4,2,2,8,Other
13526,2009-12-01 13:13:00,2,1182.0,737,1,2,3,6,At-Risk
13527,2011-11-06 12:04:00,12,4541.29,32,3,4,4,11,High-Value
13529,2011-09-22 09:15:00,2,307.76,77,3,2,1,6,Other
13530,2010-03-15 14:10:00,1,402.98,633,1,1,2,4,At-Risk
13531,2011-05-18 16:56:00,6,1433.07,204,2,3,3,8,Other
13532,2011-11-06 12:25:00,1,210.31,32,3,1,1,5,One-Time
13533,2011-06-10 11:54:00,3,269.09,181,2,2,1,5,Other
13534,2011-12-07 14:52:00,35,7720.9,1,4,4,4,12,High-Value
13535,2010-11-02 11:49:00,1,89.5,401,1,1,1,3,At-Risk
13536,2011-12-08 16:38:00,7,3444.39,0,4,3,4,11,High-Value
13537,2010-10-10 12:45:00,2,717.85,424,1,2,2,5,At-Risk
13538,2011-10-27 16:34:00,12,3103.13,42,3,4,4,11,High-Value
13539,2011-09-15 10:18:00,7,1569.36,84,3,3,3,9,High-Value
13540,2010-08-29 14:20:00,3,632.39,466,1,2,2,5,At-Risk
13541,2010-10-08 16:37:00,2,785.25,426,1,2,2,5,At-Risk
13542,2010-11-28 11:24:00,17,3959.49,375,2,4,4,10,High-Value
13543,2010-03-15 13:34:00,2,1439.61,633,1,2,3,6,At-Risk
13544,2011-10-31 11:57:00,6,790.2,38,3,3,2,8,Loyal
13545,2010-11-14 11:27:00,2,364.93,389,1,2,2,5,At-Risk
13546,2011-11-27 14:50:00,5,1086.24,11,4,3,3,10,High-Value
13547,2010-10-27 14:14:00,1,164.53,407,1,1,1,3,At-Risk
13548,2011-09-04 14:50:00,3,901.44,95,2,2,3,7,Other
13549,2011-11-14 09:20:00,8,1005.8,24,4,4,3,11,High-Value
13550,2010-11-21 15:24:00,1,342.55,382,1,1,2,4,At-Risk
13551,2011-01-24 14:46:00,2,244.2,318,2,2,1,5,Other
13552,2011-10-04 15:19:00,22,6948.92,65,3,4,4,11,High-Value
13553,2010-02-03 12:21:00,1,499.6,673,1,1,2,4,At-Risk
13554,2010-11-24 15:05:00,7,1629.35,379,1,3,3,7,At-Risk
13555,2011-09-27 12:36:00,13,8891.84,72,3,4,4,11,High-Value
13556,2010-10-06 16:44:00,2,200.82,428,1,2,1,4,At-Risk
13557,2011-11-11 15:24:00,13,3032.26,27,3,4,4,11,High-Value
13558,2011-12-04 11:24:00,4,594.52,4,4,3,2,9,High-Value
13559,2010-07-15 09:52:00,2,990.0,511,1,2,3,6,At-Risk
13560,2011-12-02 13:11:00,1,171.42,6,4,1,1,6,One-Time
13561,2011-05-08 12:39:00,11,1803.4,214,2,4,3,9,High-Value
13562,2011-09-19 10:51:00,8,4838.18,80,3,4,4,11,High-Value
13563,2011-09-16 14:45:00,2,777.53,83,3,2,2,7,Other
13564,2010-12-20 16:50:00,36,15880.22,353,2,4,4,10,High-Value
13565,2011-11-20 14:33:00,3,414.8,18,4,2,2,8,Other
13566,2011-10-30 11:59:00,5,1684.75,39,3,3,3,9,High-Value
13567,2010-10-07 12:51:00,4,1079.29,427,1,3,3,7,At-Risk
13568,2011-06-19 14:42:00,1,187.05,172,2,1,1,4,One-Time
13569,2011-11-22 13:07:00,4,725.04,16,4,3,2,9,High-Value
13570,2011-04-10 13:36:00,1,239.49,242,2,1,1,4,One-Time
13571,2011-11-27 10:47:00,26,4537.26,11,4,4,4,12,High-Value
13572,2011-05-18 11:59:00,1,1384.25,204,2,1,3,6,Other
13573,2011-10-20 14:33:00,6,903.07,49,3,3,3,9,High-Value
13574,2010-10-24 13:28:00,1,404.45,410,1,1,2,4,At-Risk
13575,2011-11-16 13:14:00,5,732.07,22,4,3,2,9,High-Value
13576,2011-11-29 15:34:00,28,11202.59,9,4,4,4,12,High-Value
13577,2011-11-14 15:19:00,11,3484.28,24,4,4,4,12,High-Value
13578,2010-10-26 13:44:00,1,147.66,408,1,1,1,3,At-Risk
13579,2011-11-25 08:41:00,5,1374.34,13,4,3,3,10,High-Value
13580,2010-10-29 15:01:00,1,107.75,405,1,1,1,3,At-Risk
13581,2011-02-03 14:41:00,2,280.53,308,2,2,1,5,Other
13582,2010-11-15 11:34:00,2,241.68,388,1,2,1,4,At-Risk
13583,2011-07-07 10:40:00,2,1445.03,154,2,2,3,7,Other
13584,2011-02-06 12:49:00,3,385.7,305,2,2,2,6,Other
13585,2010-06-27 12:33:00,3,684.54,529,1,2,2,5,At-Risk
13586,2010-06-16 13:47:00,1,127.28,540,1,1,1,3,At-Risk
13587,2011-10-07 12:31:00,4,1673.5,62,3,3,3,9,High-Value
13588,2011-11-24 10:42:00,9,2478.95,14,4,4,4,12,High-Value
13589,2011-11-25 12:10:00,6,1120.74,13,4,3,3,10,High-Value
13590,2011-11-28 12:54:00,18,6336.04,10,4,4,4,12,High-Value
13591,2011-10-06 12:26:00,7,2093.94,63,3,3,3,9,High-Value
13592,2011-11-04 09:49:00,4,247.96,34,3,3,1,7,Loyal
13593,2011-08-23 13:35:00,14,5493.29,107,2,4,4,10,High-Value
13594,2011-10-18 10:19:00,2,533.32,51,3,2,2,7,Other
13595,2010-07-11 12:36:00,3,784.48,515,1,2,2,5,At-Risk
13596,2011-12-04 12:01:00,2,664.11,4,4,2,2,8,Other
13597,2010-11-04 14:54:00,2,396.71,399,1,2,2,5,At-Risk
13598,2011-10-23 14:28:00,5,761.96,46,3,3,2,8,Loyal
13599,2011-12-08 16:10:00,33,9811.04,0,4,4,4,12,High-Value
13600,2011-01-31 15:27:00,2,518.42,311,2,2,2,6,Other
13601,2011-10-25 17:31:00,4,1159.99,44,3,3,3,9,High-Value
13602,2011-10-06 11:47:00,4,1025.17,63,3,3,3,9,High-Value
13603,2011-11-13 15:57:00,1,164.34,25,3,1,1,5,One-Time
13604,2010-02-19 12:02:00,1,717.62,657,1,1,2,4,At-Risk
13605,2010-11-17 17:16:00,2,522.67,386,1,2,2,5,At-Risk
13606,2011-11-10 17:46:00,3,276.75,28,3,2,1,6,Other
13607,2011-10-30 16:17:00,2,1075.81,39,3,2,3,8,Other
13608,2010-06-17 12:28:00,1,232.05,539,1,1,1,3,At-Risk
13609,2010-04-25 13:26:00,1,167.35,592,1,1,1,3,At-Risk
13610,2011-11-27 15:38:00,14,2102.46,11,4,4,3,11,High-Value
13611,2011-09-11 14:51:00,10,3297.93,88,3,4,4,11,High-Value
13612,2010-03-17 12:14:00,1,818.29,631,1,1,2,4,At-Risk
13613,2010-09-13 12:01:00,5,1039.85,451,1,3,3,7,At-Risk
13614,2011-11-15 14:47:00,6,2332.74,23,4,3,4,11,High-Value
13615,2011-01-25 08:21:00,8,6272.53,317,2,4,4,10,High-Value
13616,2010-05-20 12:59:00,2,283.85,567,1,2,1,4,At-Risk
13617,2011-10-30 13:50:00,8,1278.75,39,3,4,3,10,High-Value
13618,2011-06-19 11:09:00,1,177.34,172,2,1,1,4,One-Time
13619,2010-06-13 11:39:00,2,223.44,543,1,2,1,4,At-Risk
13620,2010-06-29 15:02:00,1,112.34,527,1,1,1,3,At-Risk
13621,2011-08-15 08:26:00,1,213.85,115,2,1,1,4,One-Time
13622,2010-01-12 13:22:00,1,658.95,695,1,1,2,4,At-Risk
13623,2011-11-09 12:00:00,10,2533.06,29,3,4,4,11,High-Value
13624,2010-11-16 13:43:00,1,462.08,387,1,1,2,4,At-Risk
13625,2010-04-22 10:50:00,1,301.26,595,1,1,1,3,At-Risk
13626,2011-04-01 10:05:00,2,707.04,251,2,2,2,6,Other
13627,2011-10-11 14:20:00,7,2245.9,58,3,3,4,10,High-Value
13628,2010-02-01 14:44:00,1,310.14,675,1,1,1,3,At-Risk
13629,2011-11-16 13:21:00,19,13370.86,22,4,4,4,12,High-Value
13630,2011-12-04 15:16:00,7,2031.78,4,4,3,3,10,High-Value
13631,2011-09-01 09:57:00,11,3070.42,98,2,4,4,10,High-Value
13632,2011-11-15 10:51:00,8,3645.81,23,4,4,4,12,High-Value
13634,2011-11-06 13:40:00,15,4988.08,32,3,4,4,11,High-Value
13635,2011-10-03 10:55:00,4,2999.16,66,3,3,4,10,High-Value
13636,2011-11-03 10:30:00,5,949.12,35,3,3,3,9,High-Value
13637,2011-10-18 13:32:00,3,803.05,51,3,2,2,7,Other
13638,2011-11-24 10:38:00,1,122.64,14,4,1,1,6,One-Time
13639,2011-09-26 13:36:00,2,1346.27,73,3,2,3,8,Other
13640,2010-04-07 15:33:00,1,405.0,610,1,1,2,4,At-Risk
13641,2010-03-09 07:37:00,4,942.37,639,1,3,3,7,At-Risk
13642,2011-05-08 12:34:00,4,472.2,214,2,3,2,7,Other
13643,2011-11-08 15:37:00,10,2156.77,30,3,4,3,10,High-Value
13644,2011-11-23 14:07:00,4,2624.26,15,4,3,4,11,High-Value
13645,2011-08-11 16:11:00,1,252.1,119,2,1,1,4,One-Time
13646,2010-11-05 12:13:00,2,326.25,398,1,2,1,4,At-Risk
13647,2011-11-30 12:00:00,8,3041.68,8,4,4,4,12,High-Value
13648,2010-11-04 14:46:00,8,1759.07,399,1,4,3,8,At-Risk
13649,2011-03-28 11:51:00,6,1453.68,255,2,3,3,8,Other
13650,2011-11-23 12:22:00,10,3288.0,15,4,4,4,12,High-Value
13651,2011-10-31 12:11:00,2,211.85,38,3,2,1,6,Other
13652,2011-10-25 08:51:00,5,2262.05,44,3,3,4,10,High-Value
13653,2010-08-09 08:19:00,1,152.2,486,1,1,1,3,At-Risk
13654,2011-10-27 16:24:00,11,6308.0,42,3,4,4,11,High-Value
13655,2011-08-17 14:25:00,6,2280.51,113,2,3,4,9,High-Value
13656,2011-06-28 10:31:00,4,1078.85,163,2,3,3,8,Other
13657,2011-11-29 12:32:00,2,382.14,9,4,2,2,8,Other
13658,2011-11-30 10:13:00,9,6025.5,8,4,4,4,12,High-Value
13659,2011-05-18 12:37:00,12,4884.68,204,2,4,4,10,High-Value
13660,2010-11-04 16:10:00,1,306.64,399,1,1,1,3,At-Risk
13661,2010-04-15 14:58:00,1,325.24,602,1,1,1,3,At-Risk
13662,2011-09-15 12:04:00,11,2233.61,84,3,4,3,10,High-Value
13663,2011-06-13 15:44:00,5,2047.51,178,2,3,3,8,Other
13665,2010-11-18 13:06:00,3,1711.66,385,1,2,3,6,At-Risk
13666,2011-10-10 15:39:00,5,127.05,59,3,3,1,7,Loyal
13667,2011-07-13 15:42:00,1,299.05,148,2,1,1,4,One-Time
13668,2011-12-07 12:11:00,35,12948.48,1,4,4,4,12,High-Value
13669,2011-10-20 09:32:00,3,413.55,49,3,2,2,7,Other
13670,2011-09-25 15:25:00,1,349.7,74,3,1,2,6,Other
13671,2010-11-10 10:50:00,1,172.6,393,1,1,1,3,At-Risk
13672,2011-02-11 13:53:00,3,419.92,300,2,2,2,6,Other
13673,2011-11-21 12:11:00,2,387.44,17,4,2,2,8,Other
13674,2010-10-03 10:41:00,1,240.68,431,1,1,1,3,At-Risk
13675,2011-07-11 12:57:00,2,486.82,150,2,2,2,6,Other
13676,2010-06-18 17:30:00,2,243.9,538,1,2,1,4,At-Risk
13677,2010-10-31 11:32:00,2,551.24,403,1,2,2,5,At-Risk
13678,2011-07-11 10:14:00,1,232.6,150,2,1,1,4,One-Time
13679,2010-08-03 12:13:00,3,281.26,492,1,2,1,4,At-Risk
13680,2011-12-08 13:47:00,12,11419.67,0,4,4,4,12,High-Value
13681,2011-11-22 11:13:00,4,827.83,16,4,3,2,9,High-Value
13682,2011-06-05 14:06:00,1,59.5,186,2,1,1,4,One-Time
13683,2010-09-08 10:00:00,1,258.6,456,1,1,1,3,At-Risk
13684,2011-02-27 10:13:00,4,594.88,284,2,3,2,7,Other
13685,2011-12-07 11:41:00,7,3119.44,1,4,3,4,11,High-Value
13686,2011-06-10 09:10:00,3,409.04,181,2,2,2,6,Other
13687,2010-09-27 16:30:00,1,11880.84,437,1,1,4,6,At-Risk
13688,2010-03-14 14:11:00,1,375.5,634,1,1,2,4,At-Risk
13689,2011-10-07 13:21:00,2,1259.5,62,3,2,3,8,Other
13690,2011-10-11 15:03:00,1,172.25,58,3,1,1,5,One-Time
13691,2010-11-08 17:34:00,1,210.78,395,1,1,1,3,At-Risk
13692,2011-11-15 11:17:00,5,3114.4,23,4,3,4,11,High-Value
13693,2010-11-30 18:21:00,9,2011.82,373,2,4,3,9,High-Value
13694,2011-12-06 09:32:00,143,195640.69,2,4,4,4,12,High-Value
13695,2011-11-08 14:26:00,16,2770.73,30,3,4,4,11,High-Value
13696,2010-10-14 09:44:00,3,2020.4,420,1,2,3,6,At-Risk
13697,2011-11-01 09:14:00,1,151.3,37,3,1,1,5,One-Time
13698,2010-04-22 11:52:00,2,451.73,595,1,2,2,5,At-Risk
13699,2011-07-07 16:51:00,2,764.15,154,2,2,2,6,Other
13700,2011-11-13 13:00:00,13,2596.97,25,3,4,4,11,High-Value
13701,2010-09-19 12:39:00,1,161.0,445,1,1,1,3,At-Risk
13702,2010-09-20 11:40:00,1,135.18,444,1,1,1,3,At-Risk
13703,2011-01-25 13:10:00,2,425.56,317,2,2,2,6,Other
13704,2011-12-04 15:13:00,9,2308.06,4,4,4,4,12,High-Value
13705,2011-12-02 12:32:00,7,1717.19,6,4,3,3,10,High-Value
13706,2011-02-10 09:21:00,2,631.17,301,2,2,2,6,Other
13707,2011-03-17 18:03:00,5,3365.86,266,2,3,4,9,High-Value
13708,2011-03-13 13:46:00,1,283.33,270,2,1,1,4,One-Time
13709,2011-12-06 10:28:00,18,7571.35,2,4,4,4,12,High-Value
13710,2011-11-08 08:16:00,3,509.52,30,3,2,2,7,Other
13711,2011-05-05 10:31:00,9,1792.26,217,2,4,3,9,High-Value
13712,2011-04-07 12:33:00,2,766.42,245,2,2,2,6,Other
13713,2010-10-27 16:18:00,3,740.76,407,1,2,2,5,At-Risk
13714,2010-08-31 13:57:00,1,161.35,464,1,1,1,3,At-Risk
13715,2011-03-03 19:21:00,17,8153.04,280,2,4,4,10,High-Value
13716,2011-03-15 13:49:00,1,138.28,268,2,1,1,4,One-Time
13717,2011-11-07 14:13:00,8,1763.3,31,3,4,3,10,High-Value
13718,2011-04-07 13:24:00,2,306.55,245,2,2,1,5,Other
13719,2011-11-24 15:26:00,11,2782.1,14,4,4,4,12,High-Value
13720,2011-08-15 12:46:00,4,799.9,115,2,3,2,7,Other
13721,2011-11-03 14:05:00,2,741.54,35,3,2,2,7,Other
13722,2011-07-31 12:44:00,10,5635.41,130,2,4,4,10,High-Value
13723,2011-05-06 17:04:00,6,1194.08,216,2,3,3,8,Other
13724,2010-03-12 15:28:00,1,213.01,636,1,1,1,3,At-Risk
13725,2011-10-21 10:03:00,8,1980.56,48,3,4,3,10,High-Value
13726,2011-11-01 10:49:00,2,1079.66,37,3,2,3,8,Other
13727,2011-11-11 09:46:00,8,1074.15,27,3,4,3,10,High-Value
13728,2011-11-03 10:49:00,16,2855.17,35,3,4,4,11,High-Value
13729,2010-09-30 10:44:00,3,724.73,434,1,2,2,5,At-Risk
13730,2011-07-27 08:35:00,2,752.6,134,2,2,2,6,Other
13731,2011-05-04 14:33:00,2,610.59,218,2,2,2,6,Other
13732,2011-11-11 15:49:00,1,491.86,27,3,1,2,6,Other
13733,2010-10-25 12:18:00,2,487.03,409,1,2,2,5,At-Risk
13734,2010-07-19 12:04:00,4,6695.69,507,1,3,4,8,At-Risk
13735,2011-11-15 11:14:00,13,9762.77,23,4,4,4,12,High-Value
13736,2011-12-04 15:19:00,7,2752.47,4,4,3,4,11,High-Value
13737,2011-05-23 16:32:00,1,339.6,199,2,1,2,5,Other
13738,2010-11-08 15:23:00,1,434.78,395,1,1,2,4,At-Risk
13739,2011-11-21 13:35:00,2,292.2,17,4,2,1,7,Other
13740,2011-04-13 10:32:00,5,1582.77,239,2,3,3,8,Other
13741,2011-09-29 09:19:00,3,668.43,70,3,2,2,7,Other
13742,2011-11-23 11:07:00,12,3107.87,15,4,4,4,12,High-Value
13743,2011-12-07 10:09:00,7,1341.6,1,4,3,3,10,High-Value
13744,2011-09-05 15:19:00,2,1080.52,94,3,2,3,8,Other
13745,2011-06-30 16:43:00,2,777.36,161,2,2,2,6,Other
13746,2010-10-22 11:55:00,1,176.69,412,1,1,1,3,At-Risk
13747,2010-12-01 10:37:00,2,169.8,372,2,2,1,5,Other
13748,2011-09-05 09:45:00,9,2064.35,94,3,4,3,10,High-Value
13750,2011-10-17 12:16:00,11,3602.18,52,3,4,4,11,High-Value
13751,2011-02-24 15:56:00,1,296.25,287,2,1,1,4,One-Time
13752,2011-08-07 14:16:00,7,1579.83,123,2,4,3,9,High-Value
13753,2011-02-25 12:48:00,4,2094.57,286,2,3,3,8,Other
13754,2011-07-11 11:51:00,3,447.05,150,2,2,2,6,Other
13755,2011-12-06 12:26:00,9,2108.06,2,4,4,3,11,High-Value
13756,2011-12-07 16:44:00,23,8655.95,1,4,4,4,12,High-Value
13757,2010-02-03 12:37:00,1,195.55,673,1,1,1,3,At-Risk
13758,2011-11-28 11:11:00,14,8595.29,10,4,4,4,12,High-Value
13759,2011-11-06 14:47:00,2,659.41,32,3,2,2,7,Other
13760,2011-10-16 16:13:00,5,1363.64,53,3,3,3,9,High-Value
13761,2011-10-20 14:01:00,6,1952.17,49,3,3,3,9,High-Value
13762,2011-05-05 09:15:00,5,2472.48,217,2,3,4,9,High-Value
13763,2011-10-07 15:13:00,3,5217.44,62,3,2,4,9,High-Value
13764,2011-09-30 12:03:00,6,2908.67,69,3,3,4,10,High-Value
13765,2010-02-24 13:46:00,1,352.82,652,1,1,2,4,At-Risk
13766,2010-08-01 14:25:00,1,190.35,494,1,1,1,3,At-Risk
13767,2011-12-07 15:00:00,73,33903.57,1,4,4,4,12,High-Value
13768,2009-12-13 10:41:00,2,875.97,725,1,2,3,6,At-Risk
13769,2011-12-07 15:08:00,20,5478.12,1,4,4,4,12,High-Value
13770,2010-10-13 15:10:00,4,785.37,421,1,3,2,6,At-Risk
13771,2011-10-06 14:18:00,9,5728.82,63,3,4,4,11,High-Value
13772,2011-11-06 11:43:00,8,3100.02,32,3,4,4,11,High-Value
13773,2010-11-08 11:49:00,2,301.54,395,1,2,1,4,At-Risk
13774,2011-09-19 12:06:00,1,345.0,80,3,1,2,6,Other
13775,2010-04-28 12:15:00,1,1049.66,589,1,1,3,5,At-Risk
13777,2011-12-09 12:25:00,61,49638.26,-1,4,4,4,12,High-Value
13778,2011-08-28 15:25:00,4,1124.49,102,2,3,3,8,Other
13779,2010-07-12 11:24:00,1,161.13,514,1,1,1,3,At-Risk
13780,2011-12-02 13:49:00,3,732.07,6,4,2,2,8,Other
13781,2011-04-03 12:08:00,3,778.83,249,2,2,2,6,Other
13782,2011-11-27 11:54:00,13,1786.08,11,4,4,3,11,High-Value
13783,2010-08-09 09:23:00,4,1542.09,486,1,3,3,7,At-Risk
13784,2011-11-30 09:33:00,14,2910.23,8,4,4,4,12,High-Value
13785,2010-10-07 09:25:00,4,542.49,427,1,3,2,6,At-Risk
13786,2010-12-07 13:53:00,6,3127.99,366,2,3,4,9,High-Value
13787,2011-09-25 12:06:00,6,1222.5,74,3,3,3,9,High-Value
13788,2010-07-22 15:50:00,1,3.75,504,1,1,1,3,At-Risk
13789,2010-11-16 15:31:00,1,239.46,387,1,1,1,3,At-Risk
13790,2011-12-05 15:48:00,1,348.8,3,4,1,2,7,Other
13791,2011-08-04 11:44:00,2,1516.0,126,2,2,3,7,Other
13792,2011-10-04 14:31:00,3,383.95,65,3,2,2,7,Other
13793,2010-03-03 08:25:00,1,96.0,645,1,1,1,3,At-Risk
13794,2010-06-11 12:30:00,1,126.03,545,1,1,1,3,At-Risk
13795,2010-11-16 17:25:00,4,836.3,387,1,3,2,6,At-Risk
13796,2010-07-28 14:45:00,1,289.7,498,1,1,1,3,At-Risk
13797,2010-09-29 10:34:00,3,1179.45,435,1,2,3,6,At-Risk
13798,2011-12-08 15:51:00,110,75428.87,0,4,4,4,12,High-Value
13799,2011-08-15 12:07:00,9,2803.57,115,2,4,4,10,High-Value
13800,2011-02-03 12:27:00,3,1679.56,308,2,2,3,7,Other
13801,2011-10-04 10:15:00,1,324.8,65,3,1,1,5,One-Time
13802,2011-07-24 10:54:00,19,26259.11,137,2,4,4,10,High-Value
13803,2011-03-29 12:57:00,3,1338.91,254,2,2,3,7,Other
13804,2011-11-09 12:32:00,9,3161.12,29,3,4,4,11,High-Value
13805,2011-10-18 14:50:00,2,924.6,51,3,2,3,8,Other
13806,2011-10-07 11:43:00,1,256.38,62,3,1,1,5,One-Time
13807,2010-12-07 15:48:00,3,422.2,366,2,2,2,6,Other
13808,2011-12-04 12:18:00,5,1747.66,4,4,3,3,10,High-Value
13809,2011-02-07 13:15:00,3,679.7,304,2,2,2,6,Other
13810,2011-11-11 08:33:00,2,827.51,27,3,2,2,7,Other
13811,2011-06-09 09:54:00,2,519.75,182,2,2,2,6,Other
13812,2011-10-28 14:27:00,3,485.0,41,3,2,2,7,Other
13813,2011-10-31 10:38:00,8,2387.47,38,3,4,4,11,High-Value
13814,2011-09-08 13:48:00,3,2257.32,91,3,2,4,9,High-Value
13815,2011-11-17 14:19:00,8,6737.74,21,4,4,4,12,High-Value
13816,2011-11-16 08:38:00,2,499.67,22,4,2,2,8,Other
13817,2011-11-10 17:49:00,2,328.98,28,3,2,1,6,Other
13818,2010-10-06 12:35:00,1,61.28,428,1,1,1,3,At-Risk
13819,2011-02-11 10:38:00,6,2642.35,300,2,3,4,9,High-Value
13820,2010-10-17 13:46:00,3,652.75,417,1,2,2,5,At-Risk
13821,2011-07-18 09:49:00,6,1379.08,143,2,3,3,8,Other
13822,2011-12-04 12:13:00,2,632.0,4,4,2,2,8,Other
13823,2011-11-21 10:22:00,7,3403.45,17,4,4,4,12,High-Value
13824,2011-11-07 12:41:00,12,3314.76,31,3,4,4,11,High-Value
13825,2010-03-28 11:02:00,2,255.59,620,1,2,1,4,At-Risk
13826,2011-06-16 13:48:00,1,189.5,175,2,1,1,4,One-Time
13827,2011-10-13 12:38:00,3,409.8,56,3,2,2,7,Other
13828,2011-11-17 16:02:00,1,209.49,21,4,1,1,6,One-Time
13829,2010-10-14 18:19:00,1,102.0,420,1,1,1,3,At-Risk
13830,2010-05-07 12:24:00,1,156.85,580,1,1,1,3,At-Risk
13831,2011-11-23 15:41:00,18,6585.54,15,4,4,4,12,High-Value
13832,2011-11-20 15:36:00,2,609.89,18,4,2,2,8,Other
13833,2011-07-03 13:27:00,2,700.41,158,2,2,2,6,Other
13834,2010-05-12 10:27:00,2,324.19,575,1,2,1,4,At-Risk
13835,2011-11-14 15:37:00,7,1095.27,24,4,4,3,11,High-Value
13836,2010-11-05 13:31:00,2,620.37,398,1,2,2,5,At-Risk
13837,2011-05-12 12:10:00,2,266.59,210,2,2,1,5,Other
13838,2011-12-04 11:00:00,10,1690.07,4,4,4,3,11,High-Value
13839,2010-08-10 13:52:00,1,139.95,485,1,1,1,3,At-Risk
13840,2010-10-19 13:34:00,1,651.4,415,1,1,2,4,At-Risk
13841,2011-04-01 12:10:00,1,85.0,251,2,1,1,4,One-Time
13842,2011-10-12 10:51:00,18,5319.34,57,3,4,4,11,High-Value
13843,2010-11-23 17:48:00,1,319.75,380,1,1,1,3,At-Risk
13844,2011-11-28 13:21:00,1,361.62,10,4,1,2,7,Other
13845,2011-10-06 08:25:00,1,312.98,63,3,1,1,5,One-Time
13846,2011-11-15 12:07:00,4,1307.79,23,4,3,3,10,High-Value
13847,2009-12-20 10:41:00,1,310.72,718,1,1,1,3,At-Risk
13848,2011-09-08 12:58:00,8,3015.0,91,3,4,4,11,High-Value
13849,2011-10-19 10:59:00,5,3469.3,50,3,3,4,10,High-Value
13850,2011-08-02 14:04:00,1,1595.48,128,2,1,3,6,Other
13851,2011-09-05 12:36:00,8,4606.46,94,3,4,4,11,High-Value
13852,2010-04-08 09:06:00,1,187.35,609,1,1,1,3,At-Risk
13853,2011-10-13 14:18:00,1,1090.14,56,3,1,3,7,Other
13854,2011-12-01 09:06:00,39,11944.56,7,4,4,4,12,High-Value
13855,2010-07-27 09:53:00,4,1310.34,499,1,3,3,7,At-Risk
13856,2011-06-24 10:03:00,11,1142.03,167,2,4,3,9,High-Value
13857,2010-11-11 12:54:00,6,1000.91,392,1,3,3,7,At-Risk
13858,2011-10-13 16:17:00,1,216.17,56,3,1,1,5,One-Time
13859,2011-01-17 16:14:00,2,515.86,325,2,2,2,6,Other
13860,2011-12-08 12:57:00,5,1245.9,0,4,3,3,10,High-Value
13861,2010-10-06 14:20:00,2,273.26,428,1,2,1,4,At-Risk
13862,2011-11-21 16:24:00,9,2556.09,17,4,4,4,12,High-Value
13863,2011-04-06 10:20:00,4,1239.55,246,2,3,3,8,Other
13864,2010-11-18 12:50:00,1,662.4,385,1,1,2,4,At-Risk
13865,2011-10-12 13:31:00,4,501.56,57,3,3,2,8,Loyal
13866,2011-09-26 14:54:00,1,145.67,73,3,1,1,5,One-Time
13867,2011-11-08 15:48:00,3,1005.09,30,3,2,3,8,Other
13868,2011-12-02 16:32:00,2,3192.54,6,4,2,4,10,High-Value
13869,2011-08-08 13:53:00,10,7996.87,122,2,4,4,10,High-Value
13870,2011-12-07 13:23:00,15,5712.08,1,4,4,4,12,High-Value
13871,2011-11-17 10:49:00,17,7885.85,21,4,4,4,12,High-Value
13872,2010-06-30 15:35:00,3,919.57,526,1,2,3,6,At-Risk
13873,2011-08-12 10:08:00,8,1038.92,118,2,4,3,9,High-Value
13874,2010-12-16 18:20:00,7,2049.15,357,2,4,3,9,High-Value
13875,2011-10-17 09:36:00,14,4814.37,52,3,4,4,11,High-Value
13876,2011-10-07 10:22:00,1,122.7,62,3,1,1,5,One-Time
13877,2011-09-14 15:49:00,3,449.68,85,3,2,2,7,Other
13878,2011-10-16 12:19:00,4,2416.9,53,3,3,4,10,High-Value
13879,2010-03-04 10:49:00,1,395.5,644,1,1,2,4,At-Risk
13880,2011-11-18 13:44:00,17,4293.86,20,4,4,4,12,High-Value
13881,2011-12-06 12:50:00,43,45179.1,2,4,4,4,12,High-Value
13882,2011-12-07 11:16:00,5,1191.13,1,4,3,3,10,High-Value
13883,2011-11-29 10:45:00,14,6535.37,9,4,4,4,12,High-Value
13884,2011-12-02 16:30:00,10,1825.03,6,4,4,3,11,High-Value
13885,2011-06-03 15:07:00,2,506.8,188,2,2,2,6,Other
13886,2011-09-29 13:17:00,1,243.56,70,3,1,1,5,One-Time
13887,2011-05-19 17:22:00,1,349.55,203,2,1,2,5,Other
13888,2011-08-12 10:13:00,7,2001.59,118,2,4,3,9,High-Value
13889,2011-09-08 09:13:00,6,1991.23,91,3,3,3,9,High-Value
13890,2011-12-08 15:36:00,14,2927.38,0,4,4,4,12,High-Value
13891,2010-11-26 15:57:00,3,859.21,377,2,2,3,7,Other
13892,2011-11-13 11:50:00,6,1267.65,25,3,3,3,9,High-Value
13893,2011-02-15 11:30:00,1,821.1,296,2,1,2,5,Other
13894,2011-11-16 09:44:00,3,564.62,22,4,2,2,8,Other
13895,2011-11-11 16:57:00,6,4008.52,27,3,3,4,10,High-Value
13896,2010-03-24 08:55:00,1,388.55,624,1,1,2,4,At-Risk
13897,2011-10-20 14:30:00,3,1160.72,49,3,2,3,8,Other
13898,2011-01-18 10:28:00,2,686.4,324,2,2,2,6,Other
13899,2011-11-23 13:40:00,2,388.52,15,4,2,2,8,Other
13900,2011-06-09 19:26:00,6,1610.59,182,2,3,3,8,Other
13901,2011-09-28 14:48:00,15,5676.34,71,3,4,4,11,High-Value
13902,2010-03-17 13:09:00,5,34023.26,631,1,3,4,8,At-Risk
13903,2010-11-04 17:44:00,1,165.45,399,1,1,1,3,At-Risk
13904,2011-11-02 13:41:00,2,332.64,36,3,2,1,6,Other
13905,2009-12-07 11:41:00,1,312.65,731,1,1,1,3,At-Risk
13906,2010-10-26 15:00:00,1,42.0,408,1,1,1,3,At-Risk
13907,2010-01-17 12:22:00,1,136.8,690,1,1,1,3,At-Risk
13908,2011-09-21 11:49:00,4,2319.55,78,3,3,4,10,High-Value
13909,2010-10-12 17:22:00,2,282.85,422,1,2,1,4,At-Risk
13911,2011-10-13 15:43:00,20,4234.99,56,3,4,4,11,High-Value
13912,2010-10-12 08:43:00,1,124.95,422,1,1,1,3,At-Risk
13913,2010-07-21 10:11:00,1,42.22,505,1,1,1,3,At-Risk
13914,2011-11-28 10:35:00,2,626.45,10,4,2,2,8,Other
13915,2010-11-10 15:17:00,1,70.8,393,1,1,1,3,At-Risk
13916,2010-09-02 10:04:00,4,1275.81,462,1,3,3,7,At-Risk
13917,2011-10-21 09:56:00,2,272.04,48,3,2,1,6,Other
13918,2011-10-21 12:25:00,2,1212.84,48,3,2,3,8,Other
13919,2011-10-11 14:24:00,4,1252.68,58,3,3,3,9,High-Value
13920,2010-10-04 12:37:00,4,1774.68,430,1,3,3,7,At-Risk
13921,2010-11-02 16:32:00,4,730.7,401,1,3,2,6,At-Risk
13922,2010-12-23 10:38:00,3,865.2,350,2,2,3,7,Other
13923,2011-10-17 12:33:00,1,351.13,52,3,1,2,6,Other
13924,2011-12-08 09:39:00,6,1838.85,0,4,3,3,10,High-Value
13925,2011-09-08 12:47:00,4,678.25,91,3,3,2,8,Loyal
13926,2011-11-16 13:16:00,1,223.85,22,4,1,1,6,One-Time
13927,2011-09-26 12:00:00,2,708.26,73,3,2,2,7,Other
13928,2011-11-29 10:33:00,4,464.57,9,4,3,2,9,High-Value
13929,2011-06-23 15:26:00,11,3494.1,168,2,4,4,10,High-Value
13930,2011-10-13 09:45:00,2,337.34,56,3,2,1,6,Other
13931,2011-09-05 10:12:00,11,5257.38,94,3,4,4,11,High-Value
13932,2011-02-18 12:02:00,1,307.4,293,2,1,1,4,One-Time
13933,2011-08-22 14:03:00,2,608.79,108,2,2,2,6,Other
13934,2011-03-21 08:39:00,1,922.1,262,2,1,3,6,Other
13935,2010-04-22 11:21:00,3,6116.92,595,1,2,4,7,At-Risk
13936,2011-06-13 08:47:00,3,939.66,178,2,2,3,7,Other
13937,2011-06-23 16:35:00,2,880.13,168,2,2,3,7,Other
13938,2011-11-04 14:37:00,1,71.66,34,3,1,1,5,One-Time
13939,2011-11-16 13:33:00,7,1560.96,22,4,4,3,11,High-Value
13940,2011-11-22 15:15:00,4,839.14,16,4,3,2,9,High-Value
13941,2011-11-18 09:43:00,15,10027.18,20,4,4,4,12,High-Value
13942,2010-06-23 12:35:00,1,320.0,533,1,1,1,3,At-Risk
13943,2010-05-11 11:30:00,1,246.54,576,1,1,1,3,At-Risk
13944,2010-02-24 15:02:00,1,200.43,652,1,1,1,3,At-Risk
13945,2010-11-10 10:00:00,2,854.15,393,1,2,2,5,At-Risk
13946,2011-09-21 13:33:00,6,1876.23,78,3,3,3,9,High-Value
13947,2011-10-05 14:42:00,1,90.6,64,3,1,1,5,One-Time
13948,2010-12-14 10:18:00,4,548.76,359,2,3,2,7,Other
13949,2011-12-07 09:35:00,6,2427.32,1,4,3,4,11,High-Value
13950,2011-11-28 14:44:00,4,745.06,10,4,3,2,9,High-Value
13951,2011-06-16 16:43:00,3,674.45,175,2,2,2,6,Other
13952,2011-05-06 09:00:00,14,12823.52,216,2,4,4,10,High-Value
13953,2011-12-02 16:04:00,12,6640.68,6,4,4,4,12,High-Value
13954,2011-12-08 12:50:00,2,439.92,0,4,2,2,8,Other
13955,2011-07-08 17:19:00,3,544.07,153,2,2,2,6,Other
13956,2011-12-04 13:20:00,5,1019.27,4,4,3,3,10,High-Value
13957,2010-10-18 10:02:00,3,458.25,416,1,2,2,5,At-Risk
13958,2010-11-25 10:11:00,8,4709.23,378,2,4,4,10,High-Value
13959,2011-09-21 15:06:00,6,1064.77,78,3,3,3,9,High-Value
13960,2011-11-18 15:27:00,2,230.22,20,4,2,1,7,Other
13961,2010-11-12 14:40:00,1,538.4,391,1,1,2,4,At-Risk
13962,2011-11-18 08:47:00,3,362.8,20,4,2,2,8,Other
13963,2011-02-04 14:43:00,17,2860.57,307,2,4,4,10,High-Value
13964,2010-11-17 13:53:00,2,438.9,386,1,2,2,5,At-Risk
13965,2010-08-20 10:40:00,3,996.61,475,1,2,3,6,At-Risk
13966,2010-09-30 13:08:00,1,384.26,434,1,1,2,4,At-Risk
13967,2011-07-17 12:02:00,2,166.3,144,2,2,1,5,Other
13968,2010-10-12 13:22:00,1,123.66,422,1,1,1,3,At-Risk
13969,2011-12-02 15:11:00,35,12973.46,6,4,4,4,12,High-Value
13970,2010-11-18 13:21:00,2,846.55,385,1,2,2,5,At-Risk
13971,2011-11-21 12:06:00,14,4667.57,17,4,4,4,12,High-Value
13972,2011-09-30 11:54:00,2,190.25,69,3,2,1,6,Other
13973,2011-02-25 15:21:00,1,264.7,286,2,1,1,4,One-Time
13974,2011-10-21 14:41:00,2,677.72,48,3,2,2,7,Other
13975,2011-11-08 13:19:00,12,5256.4,30,3,4,4,11,High-Value
13976,2011-05-17 09:13:00,4,1192.36,205,2,3,3,8,Other
13977,2010-10-24 14:08:00,1,519.81,410,1,1,2,4,At-Risk
13978,2011-11-25 11:36:00,2,196.79,13,4,2,1,7,Other
13979,2011-09-27 13:32:00,7,3373.63,72,3,4,4,11,High-Value
13980,2011-10-10 13:34:00,5,768.82,59,3,3,2,8,Loyal
13981,2010-10-20 10:03:00,1,331.14,414,1,1,1,3,At-Risk
13982,2011-10-31 16:24:00,9,3954.29,38,3,4,4,11,High-Value
13983,2011-11-10 11:06:00,21,6753.89,28,3,4,4,11,High-Value
13984,2011-11-13 12:38:00,12,1893.8,25,3,4,3,10,High-Value
13985,2011-12-05 17:06:00,22,10020.86,3,4,4,4,12,High-Value
13986,2011-11-22 15:00:00,1,320.46,16,4,1,1,6,One-Time
13987,2010-11-25 10:20:00,2,682.54,378,2,2,2,6,Other
13988,2011-11-20 10:15:00,8,4757.8,18,4,4,4,12,High-Value
13989,2011-10-05 09:47:00,5,2026.06,64,3,3,3,9,High-Value
13990,2011-05-10 15:19:00,1,311.3,212,2,1,1,4,One-Time
13991,2011-11-27 16:18:00,6,851.88,11,4,3,2,9,High-Value
13992,2011-11-09 15:23:00,3,219.5,29,3,2,1,6,Other
13993,2011-10-28 09:06:00,19,6775.71,41,3,4,4,11,High-Value
13994,2011-12-06 11:05:00,6,2274.14,2,4,3,4,11,High-Value
13995,2011-11-24 14:22:00,14,3902.01,14,4,4,4,12,High-Value
13996,2010-11-18 16:27:00,2,845.76,385,1,2,2,5,At-Risk
13997,2010-07-08 18:06:00,3,376.46,518,1,2,2,5,At-Risk
13998,2010-09-19 10:20:00,3,566.7,445,1,2,2,5,At-Risk
13999,2011-11-29 13:40:00,29,9502.26,9,4,4,4,12,High-Value
14000,2011-05-12 16:50:00,5,2046.34,210,2,3,3,8,Other
14001,2011-10-25 10:31:00,9,4228.85,44,3,4,4,11,High-Value
14002,2011-07-28 15:55:00,2,529.73,133,2,2,2,6,Other
14003,2009-12-07 08:53:00,1,209.41,731,1,1,1,3,At-Risk
14004,2011-10-27 14:40:00,11,6258.45,42,3,4,4,11,High-Value
14005,2011-11-30 12:41:00,5,2874.72,8,4,3,4,11,High-Value
14006,2011-08-16 09:39:00,7,2196.67,114,2,4,3,9,High-Value
14007,2010-07-15 09:06:00,1,79.48,511,1,1,1,3,At-Risk
14008,2010-10-03 13:09:00,1,509.04,431,1,1,2,4,At-Risk
14009,2011-05-25 15:47:00,3,1099.91,197,2,2,3,7,Other
14010,2010-05-23 13:00:00,2,445.15,564,1,2,2,5,At-Risk
14011,2010-08-16 15:31:00,2,457.82,479,1,2,2,5,At-Risk
14012,2011-03-07 12:26:00,1,328.8,276,2,1,1,4,One-Time
14013,2011-08-21 15:01:00,5,1084.57,109,2,3,3,8,Other
14014,2011-09-23 13:18:00,3,1948.21,76,3,2,3,8,Other
14015,2011-10-18 10:02:00,1,917.34,51,3,1,3,7,Other
14016,2011-07-01 11:29:00,11,11303.41,160,2,4,4,10,High-Value
14017,2010-05-17 14:52:00,1,229.75,570,1,1,1,3,At-Risk
14018,2010-03-04 14:23:00,1,367.15,644,1,1,2,4,At-Risk
14019,2011-10-24 10:13:00,3,1421.61,45,3,2,3,8,Other
14020,2011-11-23 09:22:00,4,1249.01,15,4,3,3,10,High-Value
14021,2011-07-07 15:46:00,7,1716.58,154,2,4,3,9,High-Value
14022,2011-04-28 14:39:00,2,792.15,224,2,2,2,6,Other
14023,2011-12-02 13:58:00,2,584.07,6,4,2,2,8,Other
14024,2011-08-10 11:30:00,3,645.74,120,2,2,2,6,Other
14025,2010-09-01 10:11:00,8,4057.9,463,1,4,4,9,High-Value
14026,2010-08-26 10:31:00,2,713.11,469,1,2,2,5,At-Risk
14027,2011-10-10 09:01:00,1,104.82,59,3,1,1,5,One-Time
14028,2010-06-07 13:33:00,3,10396.5,549,1,2,4,7,At-Risk
14029,2011-10-07 14:46:00,2,467.66,62,3,2,2,7,Other
14030,2011-11-21 16:48:00,20,7521.8,17,4,4,4,12,High-Value
14031,2011-12-02 17:13:00,44,39019.51,6,4,4,4,12,High-Value
14032,2011-12-07 15:23:00,16,4546.41,1,4,4,4,12,High-Value
14033,2010-06-02 15:10:00,1,109.44,554,1,1,1,3,At-Risk
14034,2011-11-17 14:02:00,3,648.89,21,4,2,2,8,Other
14035,2011-11-11 10:03:00,9,2794.75,27,3,4,4,11,High-Value
14036,2011-02-28 09:26:00,1,626.65,283,2,1,2,5,Other
14037,2011-06-16 13:57:00,6,836.95,175,2,3,2,7,Other
14038,2011-09-22 13:37:00,5,3069.88,77,3,3,4,10,High-Value
14039,2011-11-06 13:48:00,2,267.28,32,3,2,1,6,Other
14040,2011-10-30 12:42:00,35,12523.81,39,3,4,4,11,High-Value
14041,2011-03-18 13:25:00,1,141.41,265,2,1,1,4,One-Time
14042,2009-12-14 15:07:00,1,431.98,724,1,1,2,4,At-Risk
14043,2010-08-05 18:18:00,2,302.6,490,1,2,1,4,At-Risk
14044,2011-11-13 12:05:00,10,3073.95,25,3,4,4,11,High-Value
14045,2011-08-22 15:27:00,16,10986.63,108,2,4,4,10,High-Value
14046,2011-02-28 14:48:00,1,151.59,283,2,1,1,4,One-Time
14047,2011-12-01 11:43:00,14,3968.11,7,4,4,4,12,High-Value
14048,2011-02-07 14:53:00,3,748.69,304,2,2,2,6,Other
14049,2011-11-23 12:20:00,13,13023.4,15,4,4,4,12,High-Value
14050,2011-11-08 10:00:00,2,746.36,30,3,2,2,7,Other
14051,2011-12-09 10:20:00,37,21770.98,-1,4,4,4,12,High-Value
14052,2011-11-20 12:30:00,2,466.66,18,4,2,2,8,Other
14053,2011-08-07 14:27:00,4,572.3,123,2,3,2,7,Other
14054,2011-10-05 15:49:00,1,92.46,64,3,1,1,5,One-Time
14055,2011-08-25 15:04:00,3,1520.96,105,2,2,3,7,Other
14056,2011-12-08 13:36:00,23,8152.71,0,4,4,4,12,High-Value
14057,2011-11-16 10:32:00,22,8346.66,22,4,4,4,12,High-Value
14058,2010-09-03 09:31:00,2,469.19,461,1,2,2,5,At-Risk
14059,2011-03-18 10:06:00,1,183.6,265,2,1,1,4,One-Time
14060,2011-12-05 12:29:00,30,8898.24,3,4,4,4,12,High-Value
14061,2010-07-20 17:22:00,3,917.43,506,1,2,3,6,At-Risk
14062,2011-11-30 10:04:00,24,25585.65,8,4,4,4,12,High-Value
14063,2010-01-22 11:28:00,7,9471.5,685,1,4,4,9,High-Value
14064,2011-11-10 13:14:00,15,3260.24,28,3,4,4,11,High-Value
14065,2010-11-15 16:13:00,3,891.02,388,1,2,3,6,At-Risk
14066,2011-03-18 12:21:00,1,152.55,265,2,1,1,4,One-Time
14067,2011-10-07 10:21:00,2,374.7,62,3,2,2,7,Other
14068,2011-01-23 16:02:00,4,1516.72,319,2,3,3,8,Other
14069,2010-07-13 12:12:00,2,225.81,513,1,2,1,4,At-Risk
14070,2010-01-24 12:27:00,1,321.6,683,1,1,1,3,At-Risk
14071,2011-12-06 12:27:00,8,1422.75,2,4,4,3,11,High-Value
14072,2010-02-11 12:31:00,1,390.85,665,1,1,2,4,At-Risk
14073,2011-11-07 15:49:00,1,151.04,31,3,1,1,5,One-Time
14074,2010-03-26 13:55:00,1,219.4,622,1,1,1,3,At-Risk
14075,2011-12-05 08:38:00,5,1724.87,3,4,3,3,10,High-Value
14076,2011-08-02 15:19:00,1,118.67,128,2,1,1,4,One-Time
14077,2011-10-30 12:35:00,6,615.08,39,3,3,2,8,Loyal
14078,2011-08-30 12:16:00,9,1551.82,100,2,4,3,9,High-Value
14079,2011-08-07 12:10:00,1,375.1,123,2,1,2,5,Other
14080,2011-11-07 11:09:00,5,1115.68,31,3,3,3,9,High-Value
14081,2011-02-10 16:17:00,10,4867.57,301,2,4,4,10,High-Value
14082,2010-12-10 11:02:00,2,413.36,363,2,2,2,6,Other
14083,2011-12-05 13:14:00,11,1082.19,3,4,4,3,11,High-Value
14084,2010-07-15 14:36:00,1,150.5,511,1,1,1,3,At-Risk
14085,2011-12-07 13:46:00,32,9705.67,1,4,4,4,12,High-Value
14086,2010-09-03 10:52:00,1,39.95,461,1,1,1,3,At-Risk
14087,2011-12-07 12:41:00,3,829.47,1,4,2,2,8,Other
14088,2011-11-29 16:16:00,16,64036.8,9,4,4,4,12,High-Value
14089,2011-10-14 10:38:00,1,158.75,55,3,1,1,5,One-Time
14090,2011-01-19 10:51:00,1,76.32,323,2,1,1,4,One-Time
14091,2010-02-23 15:17:00,2,9530.08,653,1,2,4,7,At-Risk
14092,2011-12-02 12:13:00,24,7229.45,6,4,4,4,12,High-Value
14093,2011-11-27 16:27:00,1,433.86,11,4,1,2,7,Other
14094,2010-09-26 11:58:00,1,311.77,438,1,1,1,3,At-Risk
14095,2009-12-17 12:49:00,1,2.95,721,1,1,1,3,At-Risk
14096,2011-12-05 17:17:00,17,53258.43,3,4,4,4,12,High-Value
14097,2010-08-15 14:20:00,2,422.86,480,1,2,2,5,At-Risk
14098,2011-11-03 10:13:00,1,147.35,35,3,1,1,5,One-Time
14099,2011-11-23 13:53:00,20,5750.91,15,4,4,4,12,High-Value
14100,2011-07-25 11:01:00,1,191.95,136,2,1,1,4,One-Time
14101,2011-09-27 12:28:00,13,9961.93,72,3,4,4,11,High-Value
14102,2011-12-04 15:38:00,5,1105.88,4,4,3,3,10,High-Value
14104,2011-07-08 12:50:00,5,740.53,153,2,3,2,7,Other
14105,2011-04-14 17:58:00,5,5988.83,238,2,3,4,9,High-Value
14106,2009-12-02 14:09:00,1,214.8,736,1,1,1,3,At-Risk
14107,2011-10-19 12:12:00,11,4877.3,50,3,4,4,11,High-Value
14108,2011-11-09 10:41:00,4,1044.96,29,3,3,3,9,High-Value
14109,2011-09-28 10:18:00,1,144.2,71,3,1,1,5,One-Time
14110,2011-12-06 12:26:00,33,12987.95,2,4,4,4,12,High-Value
14111,2011-11-25 13:44:00,4,692.85,13,4,3,2,9,High-Value
14112,2011-11-17 12:30:00,13,5834.59,21,4,4,4,12,High-Value
14113,2011-12-06 12:18:00,16,7092.61,2,4,4,4,12,High-Value
14114,2011-03-11 09:42:00,7,1364.09,272,2,4,3,9,High-Value
14115,2010-07-26 12:36:00,2,622.67,500,1,2,2,5,At-Risk
14116,2011-11-20 10:29:00,5,1382.74,18,4,3,3,10,High-Value
14117,2011-07-19 09:49:00,1,90.0,142,2,1,1,4,One-Time
14118,2010-10-07 11:59:00,1,458.45,427,1,1,2,4,At-Risk
14119,2010-11-29 10:33:00,2,183.37,374,2,2,1,5,Other
14121,2011-12-06 12:19:00,4,2780.15,2,4,3,4,11,High-Value
14122,2010-10-29 15:11:00,3,362.42,405,1,2,2,5,At-Risk
14123,2009-12-06 15:35:00,1,436.18,732,1,1,2,4,At-Risk
14124,2011-09-16 13:32:00,1,419.58,83,3,1,2,6,Other
14125,2011-11-29 12:47:00,3,2720.63,9,4,2,4,10,High-Value
14126,2011-12-02 11:45:00,4,1172.46,6,4,3,3,10,High-Value
14127,2011-08-09 10:49:00,6,1900.08,121,2,3,3,8,Other
14128,2011-10-10 12:00:00,3,924.21,59,3,2,3,8,Other
14129,2011-12-08 11:02:00,9,2591.34,0,4,4,4,12,High-Value
14130,2011-01-24 16:05:00,4,1858.77,318,2,3,3,8,Other
14131,2010-03-01 11:59:00,1,168.22,647,1,1,1,3,At-Risk
14132,2011-12-07 13:35:00,11,3586.03,1,4,4,4,12,High-Value
14133,2011-08-02 11:34:00,4,911.14,128,2,3,3,8,Other
14134,2010-11-22 12:26:00,15,11123.35,381,1,4,4,9,High-Value
14135,2011-12-08 11:38:00,24,8839.67,0,4,4,4,12,High-Value
14136,2010-11-04 11:53:00,5,1570.81,399,1,3,3,7,At-Risk
14137,2010-01-13 12:30:00,1,332.7,694,1,1,1,3,At-Risk
14138,2011-12-08 12:44:00,2,965.88,0,4,2,3,9,High-Value
14139,2011-10-24 13:34:00,4,1086.8,45,3,3,3,9,High-Value
14140,2011-12-06 09:05:00,2,935.05,2,4,2,3,9,High-Value
14141,2011-12-07 09:53:00,4,915.13,1,4,3,3,10,High-Value
14142,2010-12-01 16:33:00,2,671.34,372,2,2,2,6,Other
14143,2011-07-29 09:48:00,1,115.8,132,2,1,1,4,One-Time
14144,2010-08-10 15:17:00,1,30.6,485,1,1,1,3,At-Risk
14145,2011-10-24 12:10:00,7,7600.05,45,3,4,4,11,High-Value
14146,2011-12-01 10:18:00,12,9450.3,7,4,4,4,12,High-Value
14147,2011-09-22 18:10:00,9,2590.2,77,3,4,4,11,High-Value
14148,2011-04-20 12:02:00,2,466.29,232,2,2,2,6,Other
14149,2011-05-03 09:44:00,1,446.62,219,2,1,2,5,Other
14150,2011-11-04 10:05:00,2,658.64,34,3,2,2,7,Other
14151,2010-02-04 15:35:00,2,679.45,672,1,2,2,5,At-Risk
14152,2011-09-25 12:54:00,7,1997.34,74,3,4,3,10,High-Value
14153,2010-08-13 14:35:00,1,233.4,482,1,1,1,3,At-Risk
14154,2011-04-14 16:26:00,8,6460.7,238,2,4,4,10,High-Value
14155,2011-03-18 14:13:00,1,118.75,265,2,1,1,4,One-Time
14156,2011-11-30 10:54:00,144,303069.88,8,4,4,4,12,High-Value
14157,2011-11-20 11:32:00,5,978.69,18,4,3,3,10,High-Value
14158,2011-10-30 15:08:00,1,507.66,39,3,1,2,6,Other
14159,2011-11-20 12:36:00,20,7849.58,18,4,4,4,12,High-Value
14160,2010-04-08 14:30:00,7,8421.47,609,1,4,4,9,High-Value
14161,2011-05-08 11:41:00,7,2996.93,214,2,4,4,10,High-Value
14162,2011-06-19 11:36:00,2,289.36,172,2,2,1,5,Other
14163,2011-09-13 15:18:00,5,2594.62,86,3,3,4,10,High-Value
14164,2011-09-30 12:24:00,2,1631.77,69,3,2,3,8,Other
14165,2011-03-09 12:39:00,1,120.44,274,2,1,1,4,One-Time
14166,2010-07-22 19:42:00,2,251.15,504,1,2,1,4,At-Risk
14167,2011-10-31 14:29:00,8,1274.29,38,3,4,3,10,High-Value
14168,2010-10-15 10:49:00,2,370.45,419,1,2,2,5,At-Risk
14169,2010-10-05 08:45:00,2,613.11,429,1,2,2,5,At-Risk
14170,2010-11-29 13:10:00,3,570.18,374,2,2,2,6,Other
14171,2011-09-02 16:43:00,2,498.79,97,2,2,2,6,Other
14172,2010-04-13 13:26:00,3,369.02,604,1,2,2,5,At-Risk
14173,2011-11-29 11:54:00,6,586.0,9,4,3,2,9,High-Value
14174,2011-11-06 13:17:00,1,134.46,32,3,1,1,5,One-Time
14175,2011-10-11 11:55:00,8,7678.88,58,3,4,4,11,High-Value
14176,2011-02-15 13:12:00,5,756.46,296,2,3,2,7,Other
14177,2011-09-14 15:11:00,13,2209.69,85,3,4,3,10,High-Value
14178,2011-12-01 12:01:00,7,1580.26,7,4,4,3,11,High-Value
14179,2011-10-30 12:07:00,2,701.57,39,3,2,2,7,Other
14180,2011-11-29 10:56:00,33,6117.5,9,4,4,4,12,High-Value
14181,2010-10-25 08:27:00,2,308.35,409,1,2,1,4,At-Risk
14182,2010-09-22 11:45:00,4,678.77,442,1,3,2,6,At-Risk
14183,2010-10-24 14:45:00,2,278.34,410,1,2,1,4,At-Risk
14184,2011-10-04 12:43:00,1,452.89,65,3,1,2,6,Other
14185,2011-01-12 13:52:00,1,197.65,330,2,1,1,4,One-Time
14186,2010-10-08 13:30:00,5,1550.63,426,1,3,3,7,At-Risk
14187,2010-08-23 12:06:00,1,123.5,472,1,1,1,3,At-Risk
14188,2011-11-09 12:45:00,6,2054.36,29,3,3,3,9,High-Value
14189,2011-12-07 15:55:00,16,5503.15,1,4,4,4,12,High-Value
14190,2010-02-11 14:27:00,1,79.9,665,1,1,1,3,At-Risk
14191,2011-12-08 09:23:00,15,4817.66,0,4,4,4,12,High-Value
14192,2010-11-16 17:44:00,1,293.74,387,1,1,1,3,At-Risk
14193,2011-10-03 09:34:00,3,1210.19,66,3,2,3,8,Other
14194,2011-12-05 10:38:00,36,18670.59,3,4,4,4,12,High-Value
14195,2011-05-22 10:29:00,6,2615.6,200,2,3,4,9,High-Value
14196,2011-08-25 10:25:00,1,335.52,105,2,1,1,4,One-Time
14197,2010-10-25 10:01:00,1,390.05,409,1,1,2,4,At-Risk
14198,2011-11-21 16:35:00,9,1569.73,17,4,4,3,11,High-Value
14199,2011-05-05 13:44:00,4,1091.7,217,2,3,3,8,Other
14200,2010-04-01 13:01:00,1,379.2,616,1,1,2,4,At-Risk
14201,2011-10-10 13:27:00,10,1193.54,59,3,4,3,10,High-Value
14202,2010-11-23 17:13:00,3,847.76,380,1,2,2,5,At-Risk
14203,2010-11-07 13:35:00,1,339.34,396,1,1,1,3,At-Risk
14204,2011-12-07 13:38:00,4,1024.83,1,4,3,3,10,High-Value
14205,2011-11-23 10:55:00,9,2414.2,15,4,4,4,12,High-Value
14206,2011-04-14 16:38:00,3,1185.01,238,2,2,3,7,Other
14207,2010-01-21 09:33:00,1,157.8,686,1,1,1,3,At-Risk
14208,2011-09-06 12:48:00,2,567.05,93,3,2,2,7,Other
14209,2011-11-29 10:18:00,15,4993.27,9,4,4,4,12,High-Value
14210,2011-08-26 12:36:00,16,5556.57,104,2,4,4,10,High-Value
14211,2011-10-17 13:23:00,18,4402.29,52,3,4,4,11,High-Value
14212,2011-09-11 12:45:00,2,2190.14,88,3,2,3,8,Other
14213,2010-10-31 10:37:00,1,1192.2,403,1,1,3,5,At-Risk
14214,2011-11-09 10:31:00,5,1004.38,29,3,3,3,9,High-Value
14215,2011-11-28 12:19:00,9,3250.33,10,4,4,4,12,High-Value
14216,2011-12-06 14:56:00,5,2150.04,2,4,3,3,10,High-Value
14217,2011-12-08 11:53:00,23,3298.59,0,4,4,4,12,High-Value
14218,2011-10-28 10:00:00,1,169.48,41,3,1,1,5,One-Time
14219,2011-12-05 16:23:00,3,633.83,3,4,2,2,8,Other
14220,2011-04-06 13:23:00,4,1515.0,246,2,3,3,8,Other
14221,2011-10-28 13:42:00,17,6517.49,41,3,4,4,11,High-Value
14222,2011-06-15 16:42:00,1,683.17,176,2,1,2,5,Other
14223,2011-09-08 13:38:00,3,991.13,91,3,2,3,8,Other
14224,2011-08-21 13:24:00,9,1841.71,109,2,4,3,9,High-Value
14225,2010-10-01 10:32:00,4,2031.07,433,1,3,3,7,At-Risk
14226,2011-11-11 11:34:00,6,2985.13,27,3,3,4,10,High-Value
14227,2011-11-13 15:48:00,15,6366.16,25,3,4,4,11,High-Value
14228,2010-09-28 09:45:00,3,745.5,436,1,2,2,5,At-Risk
14229,2011-10-19 10:03:00,7,2594.04,50,3,4,4,11,High-Value
14230,2010-09-30 09:07:00,3,979.8,434,1,2,3,6,At-Risk
14231,2011-06-09 11:05:00,4,1235.62,182,2,3,3,8,Other
14232,2011-10-28 11:09:00,5,2048.07,41,3,3,3,9,High-Value
14233,2011-10-21 15:54:00,7,2904.27,48,3,4,4,11,High-Value
14234,2011-11-17 17:53:00,4,754.12,21,4,3,2,9,High-Value
14235,2011-09-25 14:37:00,9,4717.99,74,3,4,4,11,High-Value
14236,2011-09-20 09:13:00,5,1555.34,79,3,3,3,9,High-Value
14237,2010-12-01 13:20:00,2,471.14,372,2,2,2,6,Other
14238,2011-01-17 14:40:00,3,434.23,325,2,2,2,6,Other
14239,2011-10-27 14:40:00,21,4263.17,42,3,4,4,11,High-Value
14240,2011-11-09 13:45:00,3,1247.49,29,3,2,3,8,Other
14241,2011-06-09 11:46:00,2,333.7,182,2,2,1,5,Other
14242,2011-04-19 11:46:00,2,280.55,233,2,2,1,5,Other
14243,2011-12-01 11:12:00,17,7217.75,7,4,4,4,12,High-Value
14244,2010-02-17 11:40:00,1,366.42,659,1,1,2,4,At-Risk
14245,2011-05-04 08:40:00,2,1693.45,218,2,2,3,7,Other
14246,2011-08-21 11:50:00,3,1474.06,109,2,2,3,7,Other
14247,2011-03-06 15:21:00,5,753.56,277,2,3,2,7,Other
14248,2011-01-25 14:45:00,3,1032.95,317,2,2,3,7,Other
14249,2010-10-25 12:34:00,12,5400.46,409,1,4,4,9,High-Value
14250,2011-12-02 14:30:00,3,1904.05,6,4,2,3,9,High-Value
14251,2011-12-08 08:32:00,5,2879.7,0,4,3,4,11,High-Value
14252,2010-11-23 13:36:00,1,350.99,380,1,1,2,4,At-Risk
14253,2010-08-03 14:55:00,2,363.4,492,1,2,2,5,At-Risk
14254,2010-10-03 11:52:00,1,601.03,431,1,1,2,4,At-Risk
14256,2011-03-24 13:17:00,5,2460.79,259,2,3,4,9,High-Value
14257,2011-10-06 16:54:00,9,5954.45,63,3,4,4,11,High-Value
14258,2011-11-30 15:27:00,25,32051.34,8,4,4,4,12,High-Value
14259,2011-07-21 10:44:00,1,120.0,140,2,1,1,4,One-Time
14260,2010-08-25 14:55:00,3,824.28,470,1,2,2,5,At-Risk
14261,2011-10-20 10:04:00,2,1163.45,49,3,2,3,8,Other
14262,2011-12-01 14:17:00,8,2618.23,7,4,4,4,12,High-Value
14263,2010-10-12 14:09:00,1,322.93,422,1,1,1,3,At-Risk
14264,2011-07-08 10:20:00,6,1517.36,153,2,3,3,8,Other
14265,2011-08-22 13:32:00,4,1373.35,108,2,3,3,8,Other
14266,2010-10-07 13:32:00,1,40.56,427,1,1,1,3,At-Risk
14267,2011-06-30 10:09:00,3,1516.24,161,2,2,3,7,Other
14268,2010-08-26 10:45:00,1,354.85,469,1,1,2,4,At-Risk
14269,2010-09-26 12:53:00,1,295.73,438,1,1,1,3,At-Risk
14270,2011-01-12 09:33:00,1,492.65,330,2,1,2,5,Other
14271,2011-04-28 12:47:00,2,214.18,224,2,2,1,5,Other
14272,2011-09-27 10:08:00,4,920.81,72,3,3,3,9,High-Value
14273,2011-10-19 13:20:00,4,559.97,50,3,3,2,8,Loyal
14274,2010-01-22 12:51:00,1,256.6,685,1,1,1,3,At-Risk
14275,2010-11-09 09:06:00,6,1189.38,394,1,3,3,7,At-Risk
14276,2011-09-02 09:45:00,7,2102.68,97,2,4,3,9,High-Value
14277,2011-11-24 15:01:00,8,16789.16,14,4,4,4,12,High-Value
14278,2010-10-26 12:07:00,1,205.83,408,1,1,1,3,At-Risk
14279,2010-07-07 08:42:00,2,191.86,519,1,2,1,4,At-Risk
14280,2011-05-27 10:37:00,1,134.04,195,2,1,1,4,One-Time
14281,2010-10-27 14:45:00,1,245.15,407,1,1,1,3,At-Risk
14282,2011-12-06 17:04:00,25,7250.76,2,4,4,4,12,High-Value
14283,2010-09-02 14:46:00,4,628.44,462,1,3,2,6,At-Risk
14284,2011-11-09 08:11:00,3,1299.65,29,3,2,3,8,Other
14285,2011-11-18 14:50:00,8,3284.42,20,4,4,4,12,High-Value
14286,2011-11-16 10:34:00,7,8479.76,22,4,4,4,12,High-Value
14287,2011-12-01 13:25:00,3,176.63,7,4,2,1,7,Other
14288,2011-05-10 13:22:00,1,426.6,212,2,1,2,5,Other
14289,2011-12-01 11:44:00,6,911.26,7,4,3,3,10,High-Value
14290,2011-11-28 14:02:00,8,4516.56,10,4,4,4,12,High-Value
14291,2011-12-08 10:26:00,23,7904.1,0,4,4,4,12,High-Value
14292,2011-12-02 11:50:00,16,9226.25,6,4,4,4,12,High-Value
14293,2011-12-06 15:17:00,9,2903.01,2,4,4,4,12,High-Value
14294,2010-10-28 16:25:00,1,375.34,406,1,1,2,4,At-Risk
14295,2011-10-30 15:50:00,4,2352.91,39,3,3,4,10,High-Value
14296,2010-10-14 14:14:00,2,456.4,420,1,2,2,5,At-Risk
14297,2011-11-22 09:06:00,4,1305.33,16,4,3,3,10,High-Value
14298,2011-12-01 13:12:00,82,91194.49,7,4,4,4,12,High-Value
14299,2011-12-01 16:05:00,27,14070.25,7,4,4,4,12,High-Value
14300,2011-11-21 08:57:00,1,43.2,17,4,1,1,6,One-Time
14301,2011-08-14 15:33:00,4,1992.18,116,2,3,3,8,Other
14302,2010-10-05 08:10:00,3,742.9,429,1,2,2,5,At-Risk
14303,2010-10-28 15:37:00,2,277.94,406,1,2,1,4,At-Risk
14304,2011-05-01 11:50:00,3,1725.01,221,2,2,3,7,Other
14305,2011-09-29 15:29:00,3,1858.96,70,3,2,3,8,Other
14306,2011-10-19 13:23:00,6,3151.4,50,3,3,4,10,High-Value
14307,2011-09-12 09:38:00,10,4287.92,87,3,4,4,11,High-Value
14309,2011-12-01 13:33:00,11,3780.81,7,4,4,4,12,High-Value
14310,2010-10-03 12:34:00,1,492.1,431,1,1,2,4,At-Risk
14311,2011-04-11 10:14:00,2,516.45,241,2,2,2,6,Other
14312,2011-10-24 09:46:00,11,3090.29,45,3,4,4,11,High-Value
14314,2011-08-25 10:39:00,2,229.8,105,2,2,1,5,Other
14315,2011-10-26 12:06:00,8,3197.82,43,3,4,4,11,High-Value
14316,2010-10-13 16:31:00,5,1370.34,421,1,3,3,7,At-Risk
14317,2011-10-06 10:44:00,1,508.58,63,3,1,2,6,Other
14318,2010-09-05 15:32:00,1,158.02,459,1,1,1,3,At-Risk
14319,2010-10-11 13:38:00,1,494.85,423,1,1,2,4,At-Risk
14320,2011-05-17 09:24:00,5,1346.75,205,2,3,3,8,Other
14321,2011-11-29 09:47:00,7,2218.06,9,4,4,3,11,High-Value
14322,2010-10-06 15:17:00,4,474.1,428,1,3,2,6,At-Risk
14323,2011-08-17 11:37:00,2,605.06,113,2,2,2,6,Other
14324,2010-10-26 11:44:00,2,701.61,408,1,2,2,5,At-Risk
14325,2010-05-19 09:20:00,1,245.48,568,1,1,1,3,At-Risk
14326,2011-04-11 15:04:00,3,940.98,241,2,2,3,7,Other
14327,2011-06-29 13:58:00,6,1894.93,162,2,3,3,8,Other
14329,2011-11-22 15:50:00,15,9887.62,16,4,4,4,12,High-Value
14330,2010-03-26 09:10:00,1,200.63,622,1,1,1,3,At-Risk
14331,2011-08-07 13:17:00,2,462.66,123,2,2,2,6,Other
14332,2011-11-17 11:54:00,5,1917.41,21,4,3,3,10,High-Value
14333,2011-10-03 10:38:00,1,415.2,66,3,1,2,6,Other
14334,2011-11-23 10:01:00,12,4318.48,15,4,4,4,12,High-Value
14335,2011-11-23 13:41:00,2,454.86,15,4,2,2,8,Other
14336,2011-11-23 11:40:00,4,1614.91,15,4,3,3,10,High-Value
14338,2011-07-01 14:08:00,3,928.1,160,2,2,3,7,Other
14339,2011-04-11 11:06:00,2,620.27,241,2,2,2,6,Other
14340,2011-05-05 09:44:00,1,134.7,217,2,1,1,4,One-Time
14341,2011-10-25 15:48:00,18,4452.02,44,3,4,4,11,High-Value
14342,2011-11-18 13:21:00,6,918.44,20,4,3,3,10,High-Value
14343,2010-10-14 13:05:00,4,1079.66,420,1,3,3,7,At-Risk
14344,2011-08-04 13:51:00,20,2993.05,126,2,4,4,10,High-Value
14345,2011-11-01 09:51:00,1,108.98,37,3,1,1,5,One-Time
14346,2011-08-11 09:47:00,5,2315.75,119,2,3,4,9,High-Value
14347,2009-12-03 10:49:00,1,82.6,735,1,1,1,3,At-Risk
14348,2011-03-24 16:23:00,1,409.57,259,2,1,2,5,Other
14349,2011-11-29 15:39:00,1,133.5,9,4,1,1,6,One-Time
14350,2011-03-10 14:14:00,3,972.03,273,2,2,3,7,Other
14351,2011-06-28 11:56:00,1,51.0,163,2,1,1,4,One-Time
14352,2011-07-05 15:41:00,4,1078.96,156,2,3,3,8,Other
14353,2011-05-08 16:06:00,3,376.5,214,2,2,2,6,Other
14354,2011-12-04 11:32:00,2,163.62,4,4,2,1,7,Other
14355,2010-12-09 12:16:00,3,840.05,364,2,2,2,6,Other
14356,2011-09-21 09:18:00,2,701.23,78,3,2,2,7,Other
14357,2011-10-27 16:23:00,1,225.12,42,3,1,1,5,One-Time
14358,2010-11-15 15:51:00,2,400.06,388,1,2,2,5,At-Risk
14359,2011-11-20 13:17:00,3,912.18,18,4,2,3,9,High-Value
14360,2011-11-08 09:12:00,4,2118.03,30,3,3,3,9,High-Value
14361,2010-05-10 12:29:00,1,214.71,577,1,1,1,3,At-Risk
14362,2011-11-17 15:08:00,1,151.5,21,4,1,1,6,One-Time
14363,2010-11-02 17:01:00,2,227.47,401,1,2,1,4,At-Risk
14364,2011-08-23 11:01:00,8,3717.35,107,2,4,4,10,High-Value
14365,2010-11-10 09:52:00,2,634.68,393,1,2,2,5,At-Risk
14366,2010-07-02 17:23:00,1,136.0,524,1,1,1,3,At-Risk
14367,2011-12-01 13:19:00,16,9227.82,7,4,4,4,12,High-Value
14368,2011-01-24 09:52:00,1,155.0,318,2,1,1,4,One-Time
14369,2010-03-07 15:47:00,2,469.13,641,1,2,2,5,At-Risk
14370,2010-09-15 10:53:00,6,1175.78,449,1,3,3,7,At-Risk
14371,2011-02-17 16:35:00,1,100.5,294,2,1,1,4,One-Time
14372,2010-09-22 16:17:00,2,860.08,442,1,2,3,6,At-Risk
14373,2010-12-16 15:40:00,1,76.55,357,2,1,1,4,One-Time
14374,2010-06-16 14:25:00,1,108.0,540,1,1,1,3,At-Risk
14375,2011-06-07 13:44:00,3,1106.82,184,2,2,3,7,Other
14376,2010-01-25 15:36:00,1,215.46,682,1,1,1,3,At-Risk
14377,2011-06-01 13:32:00,2,617.05,190,2,2,2,6,Other
14378,2010-03-28 12:22:00,1,131.25,620,1,1,1,3,At-Risk
14379,2011-10-26 16:43:00,4,1265.16,43,3,3,3,9,High-Value
14381,2011-10-18 17:10:00,2,625.94,51,3,2,2,7,Other
14382,2011-11-13 16:18:00,2,1193.63,25,3,2,3,8,Other
14383,2011-11-01 15:53:00,3,1247.69,37,3,2,3,8,Other
14384,2010-07-27 09:53:00,1,58.5,499,1,1,1,3,At-Risk
14385,2011-11-30 15:36:00,3,202.11,8,4,2,1,7,Other
14386,2011-02-16 09:45:00,1,142.4,295,2,1,1,4,One-Time
14387,2011-11-07 12:29:00,3,1727.6,31,3,2,3,8,Other
14388,2011-11-29 13:32:00,16,6388.2,9,4,4,4,12,High-Value
14389,2011-10-05 15:17:00,5,1898.01,64,3,3,3,9,High-Value
14390,2011-11-29 13:49:00,13,6150.03,9,4,4,4,12,High-Value
14391,2010-05-12 09:42:00,1,135.6,575,1,1,1,3,At-Risk
14392,2010-10-03 12:56:00,1,266.4,431,1,1,1,3,At-Risk
14393,2011-05-05 18:16:00,1,67.95,217,2,1,1,4,One-Time
14394,2010-05-24 10:43:00,1,93.8,563,1,1,1,3,At-Risk
14395,2011-12-07 14:34:00,20,7801.93,1,4,4,4,12,High-Value
14396,2011-10-05 16:09:00,7,1969.38,64,3,4,3,10,High-Value
14397,2011-12-07 09:22:00,19,2612.96,1,4,4,4,12,High-Value
14398,2010-11-03 13:46:00,2,707.79,400,1,2,2,5,At-Risk
14399,2010-11-10 13:23:00,8,2108.21,393,1,4,3,8,At-Risk
14400,2011-07-13 15:50:00,3,1732.47,148,2,2,3,7,Other
14401,2011-12-05 13:30:00,22,6795.9,3,4,4,4,12,High-Value
14402,2010-02-25 13:20:00,1,285.6,651,1,1,1,3,At-Risk
14403,2011-08-01 12:57:00,6,1880.51,129,2,3,3,8,Other
14404,2011-11-06 12:30:00,13,2724.13,32,3,4,4,11,High-Value
14405,2010-11-18 11:40:00,1,195.0,385,1,1,1,3,At-Risk
14406,2011-08-12 16:54:00,1,156.75,118,2,1,1,4,One-Time
14407,2011-08-24 14:02:00,5,2142.73,106,2,3,3,8,Other
14408,2011-11-29 11:41:00,11,4102.27,9,4,4,4,12,High-Value
14409,2011-09-29 18:18:00,9,3427.29,70,3,4,4,11,High-Value
14410,2011-09-08 15:08:00,11,2630.9,91,3,4,4,11,High-Value
14411,2011-02-02 10:56:00,1,1063.0,309,2,1,3,6,Other
14412,2011-10-28 10:45:00,3,1426.19,41,3,2,3,8,Other
14413,2010-12-12 13:37:00,3,421.72,361,2,2,2,6,Other
14414,2011-09-09 12:09:00,8,2399.33,90,3,4,4,11,High-Value
14415,2011-12-08 14:38:00,23,11980.09,0,4,4,4,12,High-Value
14416,2011-11-17 15:22:00,2,490.22,21,4,2,2,8,Other
14417,2010-11-17 10:55:00,1,524.65,386,1,1,2,4,At-Risk
14418,2011-12-06 11:39:00,3,1937.25,2,4,2,3,9,High-Value
14419,2011-11-29 11:22:00,7,1254.64,9,4,4,3,11,High-Value
14420,2011-09-01 18:07:00,4,1639.17,98,2,3,3,8,Other
14421,2011-10-13 13:24:00,6,2469.37,56,3,3,4,10,High-Value
14422,2011-12-09 11:26:00,19,10271.52,-1,4,4,4,12,High-Value
14423,2011-05-05 15:12:00,3,916.61,217,2,2,3,7,Other
14424,2011-11-22 11:48:00,1,322.08,16,4,1,1,6,One-Time
14425,2010-10-01 10:24:00,3,661.39,433,1,2,2,5,At-Risk
14426,2011-11-16 12:25:00,17,11727.94,22,4,4,4,12,High-Value
14427,2011-10-20 14:23:00,4,1263.52,49,3,3,3,9,High-Value
14428,2011-12-02 13:17:00,5,1224.06,6,4,3,3,10,High-Value
14429,2010-11-01 10:08:00,1,516.28,402,1,1,2,4,At-Risk
14430,2010-07-16 11:35:00,3,1220.9,510,1,2,3,6,At-Risk
14431,2011-02-10 10:40:00,4,2614.2,301,2,3,4,9,High-Value
14432,2011-11-30 08:04:00,6,2248.5,8,4,3,4,11,High-Value
14433,2010-08-31 12:35:00,1,280.7,464,1,1,1,3,At-Risk
14434,2011-11-18 08:56:00,6,1372.8,20,4,3,3,10,High-Value
14435,2010-07-26 12:33:00,1,90.42,500,1,1,1,3,At-Risk
14436,2011-09-02 10:13:00,2,271.7,97,2,2,1,5,Other
14437,2010-12-09 09:27:00,5,873.34,364,2,3,3,8,Other
14438,2011-02-06 14:56:00,1,131.9,305,2,1,1,4,One-Time
14439,2011-01-24 11:39:00,5,9443.04,318,2,3,4,9,High-Value
14440,2011-12-01 15:42:00,13,5982.03,7,4,4,4,12,High-Value
14441,2011-12-09 09:07:00,11,4611.69,-1,4,4,4,12,High-Value
14442,2011-05-19 11:36:00,7,5367.02,203,2,4,4,10,High-Value
14443,2011-10-17 10:10:00,5,2082.97,52,3,3,3,9,High-Value
14444,2010-09-09 18:56:00,1,120.44,455,1,1,1,3,At-Risk
14445,2010-09-10 11:09:00,1,221.65,454,1,1,1,3,At-Risk
14446,2011-12-09 11:34:00,5,1195.48,-1,4,3,3,10,High-Value
14447,2011-11-21 08:28:00,6,1711.73,17,4,3,3,10,High-Value
14448,2011-11-30 13:50:00,2,375.35,8,4,2,2,8,Other
14449,2011-11-21 12:06:00,8,2230.96,17,4,4,3,11,High-Value
14450,2011-06-12 10:46:00,7,1128.44,179,2,4,3,9,High-Value
14451,2011-10-10 13:38:00,12,3258.68,59,3,4,4,11,High-Value
14452,2011-11-29 12:06:00,4,658.95,9,4,3,2,9,High-Value
14453,2011-06-02 14:15:00,1,119.93,189,2,1,1,4,One-Time
14454,2010-11-28 13:26:00,5,977.3,375,2,3,3,8,Other
14455,2010-10-03 15:48:00,4,617.72,431,1,3,2,6,At-Risk
14456,2011-12-04 13:59:00,9,3014.32,4,4,4,4,12,High-Value
14457,2011-02-02 09:39:00,1,113.64,309,2,1,1,4,One-Time
14458,2010-11-24 12:43:00,1,219.27,379,1,1,1,3,At-Risk
14459,2011-07-07 13:35:00,2,5375.74,154,2,2,4,8,Other
14460,2011-08-21 14:19:00,9,1093.5,109,2,4,3,9,High-Value
14461,2011-07-14 17:11:00,13,6676.52,147,2,4,4,10,High-Value
14462,2011-10-04 15:55:00,12,2237.81,65,3,4,3,10,High-Value
14463,2011-09-02 15:20:00,4,786.57,97,2,3,2,7,Other
14464,2010-05-20 18:00:00,2,111.0,567,1,2,1,4,At-Risk
14465,2011-04-07 12:38:00,11,3925.85,245,2,4,4,10,High-Value
14466,2011-11-10 14:07:00,13,4267.15,28,3,4,4,11,High-Value
14467,2011-11-22 12:48:00,12,2203.24,16,4,4,3,11,High-Value
14468,2009-12-06 12:21:00,1,204.24,732,1,1,1,3,At-Risk
14469,2010-10-19 14:30:00,4,2093.46,415,1,3,3,7,At-Risk
14470,2011-11-28 10:31:00,3,712.04,10,4,2,2,8,Other
14471,2010-04-27 17:12:00,2,400.95,590,1,2,2,5,At-Risk
14472,2011-08-28 11:01:00,9,2118.72,102,2,4,3,9,High-Value
14473,2011-09-26 15:10:00,2,234.34,73,3,2,1,6,Other
14474,2011-10-24 13:26:00,2,1258.89,45,3,2,3,8,Other
14475,2011-09-29 10:46:00,4,1151.15,70,3,3,3,9,High-Value
14476,2011-03-27 15:39:00,1,193.0,256,2,1,1,4,One-Time
14477,2011-11-20 11:11:00,7,1969.6,18,4,4,3,11,High-Value
14478,2010-11-22 15:29:00,4,1276.66,381,1,3,3,7,At-Risk
14479,2011-03-31 09:07:00,4,1124.71,252,2,3,3,8,Other
14480,2011-11-28 16:35:00,4,1299.52,10,4,3,3,10,High-Value
14481,2011-06-28 10:38:00,5,2284.69,163,2,3,4,9,High-Value
14482,2011-11-21 13:14:00,12,4306.72,17,4,4,4,12,High-Value
14483,2011-03-03 10:26:00,2,257.1,280,2,2,1,5,Other
14484,2011-10-20 14:11:00,4,1070.98,49,3,3,3,9,High-Value
14485,2011-11-01 12:25:00,1,162.8,37,3,1,1,5,One-Time
14486,2010-07-16 09:42:00,2,175.5,510,1,2,1,4,At-Risk
14487,2011-11-13 12:17:00,7,1266.27,25,3,4,3,10,High-Value
14488,2011-10-03 09:30:00,1,1064.28,66,3,1,3,7,Other
14489,2011-05-16 14:51:00,4,1574.93,206,2,3,3,8,Other
14490,2010-10-29 15:04:00,2,1273.47,405,1,2,3,6,At-Risk
14491,2011-06-17 15:22:00,2,340.93,174,2,2,2,6,Other
14492,2010-10-05 13:21:00,7,1921.91,429,1,4,3,8,At-Risk
14493,2011-12-02 16:14:00,10,5087.86,6,4,4,4,12,High-Value
14494,2011-11-14 09:21:00,3,401.46,24,4,2,2,8,Other
14495,2011-10-20 12:28:00,3,174.8,49,3,2,1,6,Other
14496,2011-02-01 09:01:00,7,2363.89,310,2,4,4,10,High-Value
14497,2011-02-03 17:01:00,2,697.06,308,2,2,2,6,Other
14498,2011-10-28 12:09:00,10,3900.83,41,3,4,4,11,High-Value
14499,2011-11-13 13:01:00,7,2101.79,25,3,4,3,10,High-Value
14500,2011-09-12 16:45:00,3,356.85,87,3,2,2,7,Other
14501,2011-06-09 12:02:00,2,251.21,182,2,2,1,5,Other
14502,2011-11-20 11:50:00,11,2426.79,18,4,4,4,12,High-Value
14503,2011-12-06 13:30:00,6,3543.26,2,4,3,4,11,High-Value
14504,2011-10-23 16:00:00,4,673.26,46,3,3,2,8,Loyal
14505,2011-11-22 15:45:00,19,11873.08,16,4,4,4,12,High-Value
14506,2011-11-22 13:02:00,7,2960.25,16,4,4,4,12,High-Value
14507,2011-11-16 12:21:00,11,3216.74,22,4,4,4,12,High-Value
14508,2011-11-17 19:48:00,5,822.92,21,4,3,2,9,High-Value
14509,2010-06-23 13:21:00,1,110.95,533,1,1,1,3,At-Risk
14510,2010-11-29 12:46:00,3,979.85,374,2,2,3,7,Other
14511,2011-11-28 17:05:00,5,1314.81,10,4,3,3,10,High-Value
14512,2011-06-05 12:39:00,7,1215.97,186,2,4,3,9,High-Value
14513,2011-08-31 11:25:00,6,788.01,99,2,3,2,7,Other
14514,2011-10-09 16:05:00,9,4380.04,60,3,4,4,11,High-Value
14515,2011-11-22 11:37:00,12,3724.06,16,4,4,4,12,High-Value
14516,2010-07-11 14:07:00,1,151.17,515,1,1,1,3,At-Risk
14517,2011-11-06 14:20:00,2,330.45,32,3,2,1,6,Other
14518,2011-10-06 14:43:00,1,174.37,63,3,1,1,5,One-Time
14519,2010-01-25 11:18:00,2,203.14,682,1,2,1,4,At-Risk
14520,2011-12-08 09:46:00,2,270.6,0,4,2,1,7,Other
14521,2010-08-05 16:35:00,1,199.45,490,1,1,1,3,At-Risk
14522,2011-11-15 13:24:00,8,1748.42,23,4,4,3,11,High-Value
14523,2011-08-23 13:13:00,1,241.09,107,2,1,1,4,One-Time
14524,2011-11-08 12:29:00,13,2909.86,30,3,4,4,11,High-Value
14525,2011-11-20 11:37:00,17,8018.59,18,4,4,4,12,High-Value
14526,2010-11-15 13:32:00,1,258.65,388,1,1,1,3,At-Risk
14527,2011-12-07 12:19:00,121,27191.1,1,4,4,4,12,High-Value
14528,2011-11-02 17:09:00,1,364.22,36,3,1,2,6,Other
14529,2011-10-10 15:27:00,3,578.61,59,3,2,2,7,Other
14530,2011-11-14 10:38:00,16,6088.87,24,4,4,4,12,High-Value
14531,2010-08-17 10:16:00,1,376.34,478,1,1,2,4,At-Risk
14532,2011-04-17 13:05:00,11,3845.78,235,2,4,4,10,High-Value
14533,2011-11-15 12:05:00,11,3466.37,23,4,4,4,12,High-Value
14534,2011-12-07 12:19:00,26,6183.06,1,4,4,4,12,High-Value
14535,2011-10-10 15:39:00,9,5961.89,59,3,4,4,11,High-Value
14536,2011-03-25 12:21:00,1,170.95,258,2,1,1,4,One-Time
14537,2011-10-13 10:54:00,2,641.4,56,3,2,2,7,Other
14538,2011-10-06 10:31:00,5,1370.84,63,3,3,3,9,High-Value
14539,2011-11-24 09:50:00,2,537.48,14,4,2,2,8,Other
14540,2011-11-30 10:15:00,11,3709.64,8,4,4,4,12,High-Value
14541,2011-10-12 10:08:00,14,2491.38,57,3,4,4,11,High-Value
14542,2011-06-07 08:19:00,1,103.25,184,2,1,1,4,One-Time
14543,2011-11-11 12:45:00,39,14548.22,27,3,4,4,11,High-Value
14544,2011-11-15 15:06:00,3,2938.53,23,4,2,4,10,High-Value
14545,2010-02-03 15:23:00,1,349.25,673,1,1,2,4,At-Risk
14546,2011-12-04 13:00:00,11,5184.84,4,4,4,4,12,High-Value
14547,2011-12-06 11:06:00,8,3974.75,2,4,4,4,12,High-Value
14548,2011-07-12 12:19:00,9,2541.29,149,2,4,4,10,High-Value
14549,2011-02-01 13:47:00,4,913.6,310,2,3,3,8,Other
14550,2011-11-29 12:12:00,4,1345.06,9,4,3,3,10,High-Value
14551,2011-11-21 13:36:00,7,878.09,17,4,4,3,11,High-Value
14552,2011-07-11 12:49:00,3,507.93,150,2,2,2,6,Other
14553,2011-11-20 13:20:00,9,1818.6,18,4,4,3,11,High-Value
14554,2011-11-29 16:44:00,4,2279.49,9,4,3,4,11,High-Value
14555,2011-10-13 16:24:00,6,2304.03,56,3,3,4,10,High-Value
14556,2010-04-22 14:57:00,3,815.69,595,1,2,2,5,At-Risk
14557,2011-09-15 15:48:00,1,788.38,84,3,1,2,6,Other
14558,2010-02-23 12:51:00,3,655.5,653,1,2,2,5,At-Risk
14559,2010-11-14 16:05:00,1,75.6,389,1,1,1,3,At-Risk
14560,2011-12-02 15:22:00,44,6114.03,6,4,4,4,12,High-Value
14561,2011-09-25 12:39:00,3,1080.76,74,3,2,3,8,Other
14562,2011-12-06 11:05:00,26,6638.15,2,4,4,4,12,High-Value
14563,2010-07-18 12:01:00,2,625.42,508,1,2,2,5,At-Risk
14564,2010-10-01 09:02:00,2,2605.62,433,1,2,4,7,At-Risk
14565,2011-09-05 09:07:00,5,3709.22,94,3,3,4,10,High-Value
14566,2011-08-21 11:05:00,4,4092.0,109,2,3,4,9,High-Value
14567,2011-10-14 10:21:00,2,1530.36,55,3,2,3,8,Other
14568,2010-09-30 17:15:00,1,919.7,434,1,1,3,5,At-Risk
14569,2011-12-08 14:58:00,4,597.33,0,4,3,2,9,High-Value
14570,2011-03-04 10:58:00,3,512.4,279,2,2,2,6,Other
14571,2010-10-10 15:06:00,1,160.0,424,1,1,1,3,At-Risk
14572,2011-12-06 14:40:00,11,5520.98,2,4,4,4,12,High-Value
14573,2011-06-13 11:15:00,13,2163.12,178,2,4,3,9,High-Value
14574,2009-12-07 12:42:00,1,143.7,731,1,1,1,3,At-Risk
14575,2010-08-08 14:51:00,1,420.22,487,1,1,2,4,At-Risk
14576,2010-12-02 17:51:00,1,35.4,371,2,1,1,4,One-Time
14577,2011-11-27 12:47:00,7,1364.15,11,4,4,3,11,High-Value
14578,2011-12-06 17:18:00,1,168.63,2,4,1,1,6,One-Time
14579,2010-10-03 14:36:00,1,105.56,431,1,1,1,3,At-Risk
14580,2010-07-09 15:20:00,1,14.85,517,1,1,1,3,At-Risk
14581,2011-11-23 12:39:00,2,409.65,15,4,2,2,8,Other
14582,2011-10-30 11:56:00,1,114.11,39,3,1,1,5,One-Time
14583,2011-12-04 12:32:00,8,1660.29,4,4,4,3,11,High-Value
14584,2011-06-23 18:33:00,8,1738.16,168,2,4,3,9,High-Value
14585,2011-10-20 14:33:00,5,1143.27,49,3,3,3,9,High-Value
14586,2011-03-08 10:04:00,1,237.36,275,2,1,1,4,One-Time
14587,2011-11-21 11:34:00,9,1580.29,17,4,4,3,11,High-Value
14588,2010-05-10 15:08:00,1,135.39,577,1,1,1,3,At-Risk
14589,2010-12-03 11:42:00,1,39.75,370,2,1,1,4,One-Time
14590,2010-10-11 12:06:00,20,2993.37,423,1,4,4,9,High-Value
14591,2011-11-24 13:57:00,4,1320.21,14,4,3,3,10,High-Value
14592,2011-11-04 16:35:00,3,557.94,34,3,2,2,7,Other
14593,2011-11-18 12:48:00,12,3658.03,20,4,4,4,12,High-Value
14594,2011-12-02 13:28:00,2,363.33,6,4,2,2,8,Other
14595,2011-11-20 12:12:00,8,2164.45,18,4,4,3,11,High-Value
14596,2010-03-23 12:13:00,1,222.22,625,1,1,1,3,At-Risk
14597,2011-11-28 13:13:00,6,2184.63,10,4,3,3,10,High-Value
14598,2011-10-26 13:19:00,2,384.04,43,3,2,2,7,Other
14599,2010-11-14 14:49:00,2,457.89,389,1,2,2,5,At-Risk
14600,2011-02-07 09:48:00,2,865.17,304,2,2,3,7,Other
14601,2011-11-29 09:48:00,1,213.96,9,4,1,1,6,One-Time
14602,2010-02-21 15:47:00,1,205.36,655,1,1,1,3,At-Risk
14603,2011-03-10 10:27:00,1,660.0,273,2,1,2,5,Other
14604,2010-03-16 13:00:00,1,136.36,632,1,1,1,3,At-Risk
14605,2010-11-30 14:07:00,4,920.71,373,2,3,3,8,Other
14606,2011-12-08 19:28:00,184,29648.75,0,4,4,4,12,High-Value
14607,2011-11-24 10:35:00,20,22575.13,14,4,4,4,12,High-Value
14608,2011-12-05 16:52:00,10,3342.94,3,4,4,4,12,High-Value
14609,2011-09-28 12:54:00,10,1486.2,71,3,4,3,10,High-Value
14610,2010-11-09 10:58:00,2,24.35,394,1,2,1,4,At-Risk
14611,2010-09-22 09:19:00,2,604.33,442,1,2,2,5,At-Risk
14612,2010-10-20 16:01:00,1,877.7,414,1,1,3,5,At-Risk
14613,2010-01-28 13:02:00,1,76.32,679,1,1,1,3,At-Risk
14614,2010-11-18 13:04:00,1,295.13,385,1,1,1,3,At-Risk
14615,2010-11-10 13:36:00,5,951.76,393,1,3,3,7,At-Risk
14616,2011-04-11 09:54:00,5,527.78,241,2,3,2,7,Other
14617,2010-11-02 11:41:00,2,190.47,401,1,2,1,4,At-Risk
14618,2011-11-30 13:45:00,7,1342.32,8,4,4,3,11,High-Value
14619,2011-04-08 07:37:00,2,1291.24,244,2,2,3,7,Other
14620,2011-05-18 11:58:00,2,412.78,204,2,2,2,6,Other
14621,2011-12-08 16:22:00,9,3000.57,0,4,4,4,12,High-Value
14622,2011-06-08 12:42:00,1,320.58,183,2,1,1,4,One-Time
14623,2011-11-07 13:56:00,10,2012.3,31,3,4,3,10,High-Value
14624,2011-10-13 13:44:00,6,814.07,56,3,3,2,8,Loyal
14625,2011-05-27 15:32:00,11,4497.88,195,2,4,4,10,High-Value
14626,2011-11-16 10:37:00,11,5410.92,22,4,4,4,12,High-Value
14627,2010-11-25 16:32:00,1,462.75,378,2,1,2,5,Other
14628,2011-09-09 14:58:00,5,1998.0,90,3,3,3,9,High-Value
14629,2011-12-05 16:55:00,2,955.26,3,4,2,3,9,High-Value
14630,2010-08-12 16:38:00,1,338.65,483,1,1,1,3,At-Risk
14631,2011-10-20 11:17:00,6,2025.69,49,3,3,3,9,High-Value
14632,2011-03-22 08:49:00,1,114.56,261,2,1,1,4,One-Time
14633,2011-03-18 17:07:00,1,344.9,265,2,1,2,5,Other
14634,2010-09-28 10:40:00,4,2124.46,436,1,3,3,7,At-Risk
14635,2010-09-12 10:47:00,1,215.22,452,1,1,1,3,At-Risk
14636,2011-11-03 16:12:00,2,609.85,35,3,2,2,7,Other
14637,2010-01-31 15:52:00,1,106.68,676,1,1,1,3,At-Risk
14638,2011-10-20 10:10:00,1,443.6,49,3,1,2,6,Other
14639,2011-10-18 15:06:00,9,4978.96,51,3,4,4,11,High-Value
14640,2011-11-15 13:07:00,10,3649.36,23,4,4,4,12,High-Value
14641,2011-11-18 10:42:00,1,110.46,20,4,1,1,6,One-Time
14642,2011-10-12 11:08:00,1,96.12,57,3,1,1,5,One-Time
14643,2011-06-22 14:41:00,5,1679.89,169,2,3,3,8,Other
14644,2011-10-03 08:30:00,7,2247.72,66,3,4,4,11,High-Value
14645,2011-07-06 09:15:00,3,876.89,155,2,2,3,7,Other
14646,2011-12-08 12:12:00,145,526751.52,0,4,4,4,12,High-Value
14647,2011-05-22 13:40:00,2,506.04,200,2,2,2,6,Other
14648,2010-10-19 13:12:00,15,4463.39,415,1,4,4,9,High-Value
14649,2011-12-05 12:30:00,9,3651.19,3,4,4,4,12,High-Value
14650,2010-04-29 20:27:00,1,62.5,588,1,1,1,3,At-Risk
14651,2011-10-03 15:52:00,9,2025.52,66,3,4,3,10,High-Value
14652,2011-09-23 14:21:00,1,114.18,76,3,1,1,5,One-Time
14653,2011-12-08 13:45:00,11,3404.8,0,4,4,4,12,High-Value
14654,2009-12-01 12:57:00,1,246.86,737,1,1,1,3,At-Risk
14655,2011-12-01 16:28:00,7,3878.51,7,4,4,4,12,High-Value
14656,2011-06-23 13:51:00,5,790.0,168,2,3,2,7,Other
14657,2011-11-22 12:47:00,6,1450.19,16,4,3,3,10,High-Value
14658,2011-12-04 15:35:00,2,247.15,4,4,2,1,7,Other
14659,2011-12-01 12:17:00,9,2529.93,7,4,4,4,12,High-Value
14660,2011-09-14 11:34:00,2,285.74,85,3,2,1,6,Other
14661,2011-11-13 11:51:00,1,107.95,25,3,1,1,5,One-Time
14662,2011-11-11 12:13:00,7,1376.43,27,3,4,3,10,High-Value
14663,2010-10-05 13:21:00,2,490.6,429,1,2,2,5,At-Risk
14664,2011-11-20 10:59:00,2,636.24,18,4,2,2,8,Other
14665,2011-10-10 09:14:00,7,2749.65,59,3,4,4,11,High-Value
14666,2011-11-15 12:57:00,1,179.95,23,4,1,1,6,One-Time
14667,2011-11-29 11:30:00,54,20359.59,9,4,4,4,12,High-Value
14668,2010-09-20 15:03:00,1,111.63,444,1,1,1,3,At-Risk
14669,2011-04-12 11:43:00,7,3216.78,240,2,4,4,10,High-Value
14670,2011-03-04 14:13:00,3,583.33,279,2,2,2,6,Other
14671,2010-06-08 13:39:00,2,1127.45,548,1,2,3,6,At-Risk
14672,2011-04-19 10:19:00,4,1113.14,233,2,3,3,8,Other
14673,2011-12-06 14:31:00,7,3037.32,2,4,4,4,12,High-Value
14674,2010-07-18 14:25:00,1,173.66,508,1,1,1,3,At-Risk
14675,2011-11-23 12:58:00,2,1015.58,15,4,2,3,9,High-Value
14676,2011-11-08 13:29:00,12,8356.79,30,3,4,4,11,High-Value
14677,2010-04-26 09:48:00,1,184.91,591,1,1,1,3,At-Risk
14678,2010-05-09 14:32:00,1,403.39,578,1,1,2,4,At-Risk
14679,2010-11-23 11:51:00,3,1289.44,380,1,2,3,6,At-Risk
14680,2011-11-14 16:59:00,58,55688.5,24,4,4,4,12,High-Value
14681,2011-09-29 15:52:00,6,875.15,70,3,3,3,9,High-Value
14682,2011-06-05 12:12:00,6,1514.81,186,2,3,3,8,Other
14683,2010-04-30 17:18:00,1,146.56,587,1,1,1,3,At-Risk
14684,2011-11-14 11:33:00,6,1430.03,24,4,3,3,10,High-Value
14685,2010-05-12 13:08:00,8,4536.64,575,1,4,4,9,High-Value
14686,2010-10-21 18:31:00,5,852.53,413,1,3,2,6,At-Risk
14687,2011-08-25 11:59:00,3,1402.06,105,2,2,3,7,Other
14688,2011-12-02 12:26:00,28,7190.42,6,4,4,4,12,High-Value
14689,2011-05-15 11:22:00,1,112.8,207,2,1,1,4,One-Time
14690,2011-10-26 15:39:00,4,777.68,43,3,3,2,8,Loyal
14691,2011-11-09 12:30:00,5,2114.33,29,3,3,3,9,High-Value
14692,2011-07-25 15:08:00,12,1715.14,136,2,4,3,9,High-Value
14693,2011-03-20 12:50:00,7,1165.36,263,2,4,3,9,High-Value
14694,2010-04-01 19:46:00,1,244.31,616,1,1,1,3,At-Risk
14695,2010-07-08 14:18:00,3,1534.22,518,1,2,3,6,At-Risk
14696,2011-12-05 13:43:00,8,2473.28,3,4,4,4,12,High-Value
14697,2011-05-05 15:39:00,2,188.61,217,2,2,1,5,Other
14698,2011-12-08 12:26:00,5,1217.27,0,4,3,3,10,High-Value
14699,2011-05-09 14:54:00,4,702.6,213,2,3,2,7,Other
14700,2011-11-07 14:40:00,5,3076.06,31,3,3,4,10,High-Value
14701,2011-11-29 12:38:00,15,4487.11,9,4,4,4,12,High-Value
14702,2011-12-08 19:29:00,29,6356.98,0,4,4,4,12,High-Value
14703,2011-11-25 09:23:00,1,318.17,13,4,1,1,6,One-Time
14704,2011-11-20 12:20:00,9,1720.58,18,4,4,3,11,High-Value
14705,2011-05-25 12:39:00,1,179.0,197,2,1,1,4,One-Time
14706,2010-03-31 11:09:00,1,367.54,617,1,1,2,4,At-Risk
14707,2010-09-30 11:37:00,2,139.2,434,1,2,1,4,At-Risk
14708,2011-12-07 08:21:00,5,1793.22,1,4,3,3,10,High-Value
14709,2011-11-24 15:41:00,25,8886.33,14,4,4,4,12,High-Value
14710,2011-11-25 14:53:00,13,1899.79,13,4,4,3,11,High-Value
14711,2011-11-29 14:58:00,11,2839.62,9,4,4,4,12,High-Value
14712,2011-11-10 12:59:00,4,1328.07,28,3,3,3,9,High-Value
14713,2011-11-30 16:26:00,21,5115.36,8,4,4,4,12,High-Value
14714,2011-11-15 13:07:00,4,906.24,23,4,3,3,10,High-Value
14715,2011-11-15 12:10:00,8,1809.55,23,4,4,3,11,High-Value
14716,2011-10-27 17:29:00,3,543.28,42,3,2,2,7,Other
14717,2009-12-06 13:05:00,1,81.3,732,1,1,1,3,At-Risk
14718,2010-10-25 13:07:00,1,226.42,409,1,1,1,3,At-Risk
14719,2011-12-08 12:43:00,5,1581.84,0,4,3,3,10,High-Value
14720,2011-12-04 12:02:00,3,663.81,4,4,2,2,8,Other
14721,2010-11-25 13:08:00,1,109.07,378,2,1,1,4,One-Time
14722,2011-07-15 14:58:00,3,489.52,146,2,2,2,6,Other
14723,2011-11-29 15:23:00,11,1801.36,9,4,4,3,11,High-Value
14724,2010-04-28 13:26:00,1,341.9,589,1,1,2,4,At-Risk
14725,2011-11-15 12:42:00,4,1246.86,23,4,3,3,10,High-Value
14726,2010-02-23 12:35:00,1,116.5,653,1,1,1,3,At-Risk
14727,2011-03-10 14:45:00,3,461.03,273,2,2,2,6,Other
14728,2010-10-22 15:57:00,1,190.58,412,1,1,1,3,At-Risk
14729,2010-12-01 12:43:00,3,586.24,372,2,2,2,6,Other
14730,2011-12-08 14:39:00,8,1897.57,0,4,4,3,11,High-Value
14731,2011-10-23 15:54:00,3,380.02,46,3,2,2,7,Other
14732,2011-12-01 14:34:00,19,5517.07,7,4,4,4,12,High-Value
14733,2011-11-23 15:39:00,15,14335.15,15,4,4,4,12,High-Value
14734,2010-10-10 12:04:00,4,1056.42,424,1,3,3,7,At-Risk
14735,2011-12-06 12:09:00,55,12225.16,2,4,4,4,12,High-Value
14736,2010-08-11 15:21:00,2,374.05,484,1,2,2,5,At-Risk
14737,2011-12-06 10:16:00,4,3554.17,2,4,3,4,11,High-Value
14738,2011-10-28 08:56:00,9,1821.9,41,3,4,3,10,High-Value
14739,2011-12-05 16:54:00,25,11573.62,3,4,4,4,12,High-Value
14740,2011-05-26 18:17:00,11,4161.06,196,2,4,4,10,High-Value
14741,2011-11-28 08:48:00,7,1713.09,10,4,4,3,11,High-Value
14742,2010-09-30 14:07:00,1,579.85,434,1,1,2,4,At-Risk
14743,2010-04-26 10:26:00,1,50.48,591,1,1,1,3,At-Risk
14744,2011-11-23 12:51:00,14,3660.08,15,4,4,4,12,High-Value
14745,2011-08-19 10:05:00,12,2551.41,111,2,4,4,10,High-Value
14746,2010-10-29 14:44:00,4,593.5,405,1,3,2,6,At-Risk
14747,2011-04-04 14:09:00,1,328.2,248,2,1,1,4,One-Time
14748,2011-11-10 18:33:00,10,2681.9,28,3,4,4,11,High-Value
14749,2010-08-17 12:36:00,1,310.15,478,1,1,1,3,At-Risk
14750,2009-12-03 17:57:00,1,112.03,735,1,1,1,3,At-Risk
14751,2010-01-24 13:37:00,2,126.45,683,1,2,1,4,At-Risk
14752,2011-10-27 11:55:00,1,389.64,42,3,1,2,6,Other
14753,2011-09-13 14:50:00,2,869.51,86,3,2,3,8,Other
14754,2011-10-26 12:01:00,6,1547.93,43,3,3,3,9,High-Value
14755,2011-11-30 11:24:00,25,9972.55,8,4,4,4,12,High-Value
14756,2011-11-24 18:13:00,3,2603.76,14,4,2,4,10,High-Value
14757,2011-09-25 14:36:00,1,420.5,74,3,1,2,6,Other
14758,2011-07-18 08:21:00,7,2864.97,143,2,4,4,10,High-Value
14759,2011-12-05 12:03:00,3,1625.97,3,4,2,3,9,High-Value
14760,2011-02-15 16:27:00,1,89.2,296,2,1,1,4,One-Time
14761,2011-10-12 12:10:00,3,447.92,57,3,2,2,7,Other
14762,2011-03-21 08:20:00,2,417.57,262,2,2,2,6,Other
14764,2011-10-24 11:54:00,1,278.3,45,3,1,1,5,One-Time
14765,2011-11-10 19:53:00,3,254.11,28,3,2,1,6,Other
14766,2011-12-01 16:05:00,11,6375.73,7,4,4,4,12,High-Value
14767,2010-08-22 14:54:00,1,382.81,473,1,1,2,4,At-Risk
14768,2011-11-22 12:54:00,2,192.6,16,4,2,1,7,Other
14769,2011-12-07 10:24:00,17,15512.46,1,4,4,4,12,High-Value
14770,2011-04-21 14:21:00,8,3637.64,231,2,4,4,10,High-Value
14771,2010-03-28 12:52:00,2,594.62,620,1,2,2,5,At-Risk
14772,2011-08-19 15:04:00,1,139.26,111,2,1,1,4,One-Time
14773,2010-04-26 10:29:00,1,140.55,591,1,1,1,3,At-Risk
14774,2010-06-29 12:26:00,1,241.45,527,1,1,1,3,At-Risk
14775,2011-10-12 15:27:00,3,1011.9,57,3,2,3,8,Other
14776,2011-10-19 15:34:00,15,3708.3,50,3,4,4,11,High-Value
14777,2010-11-01 12:50:00,1,307.56,402,1,1,1,3,At-Risk
14778,2011-08-04 15:23:00,2,730.86,126,2,2,2,6,Other
14779,2011-03-04 12:42:00,3,386.15,279,2,2,2,6,Other
14780,2011-10-16 12:46:00,2,447.68,53,3,2,2,7,Other
14782,2011-01-24 11:12:00,1,200.1,318,2,1,1,4,One-Time
14783,2010-02-18 16:16:00,1,307.3,658,1,1,1,3,At-Risk
14784,2011-11-13 13:30:00,3,449.93,25,3,2,2,7,Other
14785,2011-11-29 13:21:00,2,77.4,9,4,2,1,7,Other
14786,2010-06-07 13:42:00,1,90.96,549,1,1,1,3,At-Risk
14787,2010-08-25 14:38:00,1,110.65,470,1,1,1,3,At-Risk
14788,2011-12-02 17:06:00,3,1156.32,6,4,2,3,9,High-Value
14789,2011-11-11 08:59:00,1,197.64,27,3,1,1,5,One-Time
14790,2011-11-23 09:28:00,10,2526.62,15,4,4,4,12,High-Value
14791,2010-04-12 10:24:00,1,303.63,605,1,1,1,3,At-Risk
14792,2011-10-07 09:19:00,1,6.2,62,3,1,1,5,One-Time
14793,2011-11-18 14:50:00,2,625.9,20,4,2,2,8,Other
14794,2011-12-07 10:11:00,10,1953.9,1,4,4,3,11,High-Value
14795,2011-06-26 13:04:00,1,131.45,165,2,1,1,4,One-Time
14796,2011-12-08 15:31:00,27,10167.77,0,4,4,4,12,High-Value
14797,2010-07-20 14:07:00,1,300.31,506,1,1,1,3,At-Risk
14798,2011-10-18 10:58:00,8,724.31,51,3,4,2,9,High-Value
14799,2011-10-19 16:16:00,2,338.15,50,3,2,1,6,Other
14800,2011-10-23 12:46:00,17,7180.08,46,3,4,4,11,High-Value
14801,2011-10-09 15:24:00,1,189.34,60,3,1,1,5,One-Time
14803,2011-06-30 13:58:00,3,845.55,161,2,2,2,6,Other
14804,2011-12-01 11:20:00,1,353.27,7,4,1,2,7,Other
14805,2011-11-24 16:20:00,7,1082.55,14,4,4,3,11,High-Value
14806,2011-09-25 15:32:00,2,303.43,74,3,2,1,6,Other
14807,2010-11-14 12:47:00,2,504.14,389,1,2,2,5,At-Risk
14808,2011-10-31 12:21:00,8,2718.6,38,3,4,4,11,High-Value
14809,2010-03-28 15:44:00,2,686.76,620,1,2,2,5,At-Risk
14810,2011-10-30 11:19:00,13,2354.03,39,3,4,4,11,High-Value
14811,2010-11-17 13:09:00,1,170.5,386,1,1,1,3,At-Risk
14812,2010-04-20 12:13:00,1,178.85,597,1,1,1,3,At-Risk
14813,2010-12-05 11:57:00,4,888.91,368,2,3,3,8,Other
14814,2010-05-07 14:10:00,1,152.96,580,1,1,1,3,At-Risk
14815,2011-11-03 11:36:00,2,778.5,35,3,2,2,7,Other
14816,2011-05-26 13:16:00,1,271.85,196,2,1,1,4,One-Time
14817,2011-05-23 13:35:00,7,3609.86,199,2,4,4,10,High-Value
14818,2011-09-27 11:01:00,6,1153.56,72,3,3,3,9,High-Value
14819,2011-10-06 13:41:00,4,456.41,63,3,3,2,8,Loyal
14820,2011-11-18 15:41:00,9,1274.76,20,4,4,3,11,High-Value
14821,2010-12-08 08:43:00,7,1230.15,365,2,4,3,9,High-Value
14822,2010-08-11 12:52:00,1,157.7,484,1,1,1,3,At-Risk
14823,2011-06-12 13:12:00,3,321.43,179,2,2,1,5,Other
14824,2011-11-29 14:20:00,10,4022.91,9,4,4,4,12,High-Value
14825,2011-12-06 11:38:00,24,4735.08,2,4,4,4,12,High-Value
14826,2010-05-07 09:00:00,2,385.2,580,1,2,2,5,At-Risk
14828,2011-05-27 10:16:00,13,9839.46,195,2,4,4,10,High-Value
14829,2011-11-10 16:16:00,7,1455.87,28,3,4,3,10,High-Value
14830,2011-10-17 14:29:00,1,188.03,52,3,1,1,5,One-Time
14831,2010-01-28 14:31:00,3,1676.57,679,1,2,3,6,At-Risk
14833,2010-07-29 10:06:00,1,94.8,497,1,1,1,3,At-Risk
14834,2011-11-22 10:30:00,7,2206.16,16,4,4,3,11,High-Value
14835,2010-06-29 10:08:00,2,297.0,527,1,2,1,4,At-Risk
14836,2011-11-29 16:45:00,3,102.45,9,4,2,1,7,Other
14837,2011-09-11 10:58:00,9,3460.32,88,3,4,4,11,High-Value
14838,2010-10-12 15:46:00,2,769.92,422,1,2,2,5,At-Risk
14839,2010-10-17 13:01:00,3,915.28,417,1,2,3,6,At-Risk
14840,2011-03-17 12:00:00,2,362.71,266,2,2,2,6,Other
14841,2011-10-17 15:03:00,14,7163.0,52,3,4,4,11,High-Value
14842,2011-10-27 12:37:00,4,2824.69,42,3,3,4,10,High-Value
14843,2010-09-29 12:39:00,1,211.8,435,1,1,1,3,At-Risk
14844,2011-10-07 10:41:00,10,6702.43,62,3,4,4,11,High-Value
14845,2010-04-19 10:19:00,1,150.0,598,1,1,1,3,At-Risk
14846,2010-10-08 17:07:00,1,437.4,426,1,1,2,4,At-Risk
14847,2011-07-14 10:52:00,3,1348.95,147,2,2,3,7,Other
14848,2010-10-31 12:22:00,1,310.56,403,1,1,1,3,At-Risk
14849,2011-11-18 10:58:00,43,15407.61,20,4,4,4,12,High-Value
14850,2011-02-01 11:21:00,7,1770.96,310,2,4,3,9,High-Value
14851,2011-11-16 14:20:00,3,829.41,22,4,2,2,8,Other
14852,2011-10-12 13:20:00,18,6132.43,57,3,4,4,11,High-Value
14853,2011-11-15 16:56:00,5,1376.87,23,4,3,3,10,High-Value
14854,2011-09-22 17:00:00,11,4303.06,77,3,4,4,11,High-Value
14855,2011-08-12 14:02:00,7,6520.3,118,2,4,4,10,High-Value
14856,2011-11-03 14:53:00,3,1290.53,35,3,2,3,8,Other
14857,2011-10-11 09:23:00,7,3651.85,58,3,4,4,11,High-Value
14858,2010-07-22 10:51:00,1,180.75,504,1,1,1,3,At-Risk
14859,2011-11-27 11:18:00,5,1705.64,11,4,3,3,10,High-Value
14860,2011-11-20 14:17:00,1,170.32,18,4,1,1,6,One-Time
14861,2011-10-18 12:54:00,10,1380.73,51,3,4,3,10,High-Value
14862,2011-11-14 10:01:00,2,841.2,24,4,2,2,8,Other
14863,2011-11-10 15:04:00,1,266.76,28,3,1,1,5,One-Time
14865,2011-12-02 16:25:00,4,92.52,6,4,3,1,8,Loyal
14866,2011-11-29 11:45:00,17,20700.04,9,4,4,4,12,High-Value
14867,2011-06-07 11:39:00,16,2952.06,184,2,4,4,10,High-Value
14868,2011-12-06 14:49:00,12,4184.01,2,4,4,4,12,High-Value
14869,2011-12-01 12:36:00,6,2778.14,7,4,3,4,11,High-Value
14870,2011-03-23 10:51:00,6,1838.95,260,2,3,3,8,Other
14871,2011-12-06 13:42:00,9,1228.17,2,4,4,3,11,High-Value
14872,2010-08-13 12:34:00,3,816.6,482,1,2,2,5,At-Risk
14873,2011-05-13 13:52:00,2,854.13,209,2,2,2,6,Other
14874,2010-06-22 14:58:00,1,116.18,534,1,1,1,3,At-Risk
14875,2011-08-24 12:20:00,3,2862.4,106,2,2,4,8,Other
14876,2010-07-06 14:57:00,2,256.7,520,1,2,1,4,At-Risk
14877,2010-10-17 13:09:00,2,425.85,417,1,2,2,5,At-Risk
14878,2011-11-27 11:15:00,25,4076.5,11,4,4,4,12,High-Value
14879,2010-01-24 11:35:00,1,185.06,683,1,1,1,3,At-Risk
14880,2011-09-23 13:42:00,3,690.59,76,3,2,2,7,Other
14881,2011-11-20 11:06:00,1,255.4,18,4,1,1,6,One-Time
14882,2011-11-13 12:47:00,14,3546.65,25,3,4,4,11,High-Value
14883,2011-11-21 10:23:00,6,761.59,17,4,3,2,9,High-Value
14884,2010-02-08 12:56:00,1,120.6,668,1,1,1,3,At-Risk
14885,2011-07-31 12:05:00,3,1598.12,130,2,2,3,7,Other
14886,2011-04-01 08:56:00,1,364.8,251,2,1,2,5,Other
14887,2011-09-21 15:32:00,1,1862.0,78,3,1,3,7,Other
14888,2011-05-16 14:58:00,1,369.2,206,2,1,2,5,Other
14889,2011-01-07 15:19:00,1,135.9,335,2,1,1,4,One-Time
14890,2011-03-31 11:57:00,3,817.25,252,2,2,2,6,Other
14891,2011-07-14 18:08:00,4,1106.73,147,2,3,3,8,Other
14892,2010-01-18 08:58:00,1,202.35,689,1,1,1,3,At-Risk
14893,2011-11-30 12:31:00,3,1809.61,8,4,2,3,9,High-Value
14894,2011-09-15 13:51:00,3,1492.81,84,3,2,3,8,Other
14895,2011-12-02 09:23:00,38,25119.54,6,4,4,4,12,High-Value
14896,2011-05-19 10:20:00,8,1826.0,203,2,4,3,9,High-Value
14897,2011-12-02 10:32:00,8,3140.54,6,4,4,4,12,High-Value
14898,2011-11-16 14:54:00,14,3365.95,22,4,4,4,12,High-Value
14899,2010-11-09 15:20:00,1,1331.38,394,1,1,3,5,At-Risk
14900,2010-07-05 15:09:00,1,13.92,521,1,1,1,3,At-Risk
14901,2011-11-28 17:09:00,12,1919.0,10,4,4,3,11,High-Value
14902,2011-11-14 10:34:00,3,1035.62,24,4,2,3,9,High-Value
14903,2011-11-18 16:07:00,5,2795.33,20,4,3,4,11,High-Value
14904,2011-12-07 12:55:00,4,1630.49,1,4,3,3,10,High-Value
14905,2011-07-05 12:41:00,8,1971.39,156,2,4,3,9,High-Value
14907,2011-12-06 14:14:00,16,5547.72,2,4,4,4,12,High-Value
14908,2011-09-26 12:56:00,2,381.9,73,3,2,2,7,Other
14909,2010-09-28 16:56:00,3,1404.68,436,1,2,3,6,At-Risk
14910,2011-12-07 10:06:00,4,434.35,1,4,3,2,9,High-Value
14911,2011-12-08 15:54:00,373,272252.79,0,4,4,4,12,High-Value
14912,2011-11-23 09:20:00,5,1849.58,15,4,3,3,10,High-Value
14913,2011-11-04 08:29:00,8,4073.13,34,3,4,4,11,High-Value
14915,2011-09-09 13:34:00,11,1811.25,90,3,4,3,10,High-Value
14916,2011-09-30 09:20:00,8,3042.95,69,3,4,4,11,High-Value
14917,2010-04-22 11:28:00,2,1123.75,595,1,2,3,6,At-Risk
14918,2011-08-16 11:50:00,9,5955.81,114,2,4,4,10,High-Value
14919,2010-06-18 13:06:00,1,359.35,538,1,1,2,4,At-Risk
14920,2011-05-11 10:32:00,3,1607.17,211,2,2,3,7,Other
14921,2011-11-09 13:17:00,2,1316.07,29,3,2,3,8,Other
14922,2010-11-11 11:14:00,2,843.74,392,1,2,2,5,At-Risk
14923,2011-10-20 11:51:00,1,749.1,49,3,1,2,6,Other
14924,2011-04-08 09:25:00,3,931.01,244,2,2,3,7,Other
14926,2010-11-23 07:13:00,2,359.4,380,1,2,2,5,At-Risk
14927,2010-11-08 12:30:00,1,308.2,395,1,1,1,3,At-Risk
14928,2010-03-22 09:14:00,1,223.91,626,1,1,1,3,At-Risk
14929,2011-11-07 17:21:00,2,836.69,31,3,2,2,7,Other
14930,2011-08-23 10:31:00,6,5236.73,107,2,3,4,9,High-Value
14931,2011-12-05 10:19:00,4,864.68,3,4,3,3,10,High-Value
14932,2010-12-09 11:48:00,2,566.13,364,2,2,2,6,Other
14933,2010-09-22 10:47:00,4,1770.0,442,1,3,3,7,At-Risk
14934,2011-09-19 10:10:00,5,3403.5,80,3,3,4,10,High-Value
14935,2011-02-15 14:44:00,2,2849.83,296,2,2,4,8,Other
14936,2011-11-06 10:30:00,12,12410.81,32,3,4,4,11,High-Value
14937,2011-10-14 12:29:00,3,1621.88,55,3,2,3,8,Other
14938,2010-05-26 13:38:00,2,2322.43,561,1,2,4,7,At-Risk
14940,2010-10-18 10:47:00,2,531.49,416,1,2,2,5,At-Risk
14941,2010-05-10 11:30:00,1,182.1,577,1,1,1,3,At-Risk
14942,2010-11-03 10:51:00,4,746.56,400,1,3,2,6,At-Risk
14943,2010-02-14 16:04:00,1,107.62,662,1,1,1,3,At-Risk
14944,2011-11-10 09:10:00,19,9684.67,28,3,4,4,11,High-Value
14945,2010-10-22 11:26:00,1,179.4,412,1,1,1,3,At-Risk
14946,2011-11-25 13:33:00,1,100.9,13,4,1,1,6,One-Time
14947,2011-09-28 15:48:00,6,1049.79,71,3,3,3,9,High-Value
14948,2011-11-16 17:16:00,6,1101.97,22,4,3,3,10,High-Value
14949,2010-08-27 15:38:00,4,515.0,468,1,3,2,6,At-Risk
14950,2011-11-20 13:48:00,1,371.2,18,4,1,2,7,Other
14951,2011-09-21 15:15:00,1,311.69,78,3,1,1,5,One-Time
14952,2011-10-11 10:33:00,32,17629.35,58,3,4,4,11,High-Value
14953,2011-11-14 14:59:00,4,968.82,24,4,3,3,10,High-Value
14954,2011-11-27 14:30:00,2,462.12,11,4,2,2,8,Other
14955,2009-12-07 11:35:00,1,163.77,731,1,1,1,3,At-Risk
14956,2010-10-14 16:40:00,1,1325.0,420,1,1,3,5,At-Risk
14957,2011-03-31 17:59:00,2,261.69,252,2,2,1,5,Other
14958,2011-07-15 14:20:00,6,941.99,146,2,3,3,8,Other
14959,2011-10-06 18:23:00,4,695.42,63,3,3,2,8,Loyal
14960,2011-12-01 12:54:00,2,221.27,7,4,2,1,7,Other
14961,2011-11-29 09:42:00,22,16410.15,9,4,4,4,12,High-Value
14962,2011-03-14 09:42:00,4,366.91,269,2,3,2,7,Other
14963,2011-11-30 12:16:00,12,3123.57,8,4,4,4,12,High-Value
14964,2011-04-06 14:13:00,1,206.21,246,2,1,1,4,One-Time
14965,2011-09-04 13:20:00,2,596.09,95,2,2,2,6,Other
14966,2011-11-25 12:20:00,6,1064.26,13,4,3,3,10,High-Value
14967,2011-10-21 11:06:00,6,1982.61,48,3,3,3,9,High-Value
14968,2011-11-09 13:58:00,2,497.49,29,3,2,2,7,Other
14969,2010-01-05 12:43:00,1,906.23,702,1,1,3,5,At-Risk
14970,2011-10-02 13:44:00,12,4919.35,67,3,4,4,11,High-Value
14971,2011-11-04 17:07:00,3,1097.98,34,3,2,3,8,Other
14972,2011-08-03 14:54:00,2,145.07,127,2,2,1,5,Other
14973,2011-08-24 15:51:00,3,1314.45,106,2,2,3,7,Other
14974,2011-11-02 13:01:00,1,89.94,36,3,1,1,5,One-Time
14975,2011-10-13 14:08:00,2,472.39,56,3,2,2,7,Other
14976,2011-10-13 16:33:00,6,774.86,56,3,3,2,8,Loyal
14977,2009-12-14 10:37:00,1,31.93,724,1,1,1,3,At-Risk
14978,2011-09-28 13:07:00,10,3112.19,71,3,4,4,11,High-Value
14979,2009-12-04 12:54:00,1,429.66,734,1,1,2,4,At-Risk
14980,2009-12-02 14:09:00,1,150.68,736,1,1,1,3,At-Risk
14981,2011-04-07 13:45:00,2,372.92,245,2,2,2,6,Other
14982,2010-05-16 15:52:00,1,234.88,571,1,1,1,3,At-Risk
14983,2010-01-19 17:32:00,1,183.2,688,1,1,1,3,At-Risk
14984,2011-11-20 14:28:00,6,1260.51,18,4,3,3,10,High-Value
14985,2011-05-25 14:29:00,2,292.01,197,2,2,1,5,Other
14986,2010-11-28 15:25:00,2,563.1,375,2,2,2,6,Other
14987,2011-11-24 09:59:00,8,1550.65,14,4,4,3,11,High-Value
14988,2011-05-12 12:05:00,7,2038.65,210,2,4,3,9,High-Value
14989,2010-02-16 10:40:00,1,342.4,660,1,1,2,4,At-Risk
14990,2010-04-06 13:54:00,2,304.17,611,1,2,1,4,At-Risk
14991,2010-10-05 13:01:00,1,314.67,429,1,1,1,3,At-Risk
14992,2010-09-23 17:48:00,1,210.5,441,1,1,1,3,At-Risk
14993,2010-05-25 12:47:00,1,36.13,562,1,1,1,3,At-Risk
14994,2010-11-22 12:59:00,5,942.77,381,1,3,3,7,At-Risk
14995,2011-11-01 11:39:00,2,231.98,37,3,2,1,6,Other
14996,2010-08-15 13:44:00,2,442.29,480,1,2,2,5,At-Risk
14997,2011-10-24 13:28:00,4,776.6,45,3,3,2,8,Loyal
14998,2011-06-22 17:30:00,4,753.18,169,2,3,2,7,Other
14999,2010-04-26 10:47:00,1,129.48,591,1,1,1,3,At-Risk
15000,2011-10-23 11:42:00,1,490.52,46,3,1,2,6,Other
15001,2010-11-10 13:51:00,2,197.11,393,1,2,1,4,At-Risk
15002,2011-08-16 10:44:00,9,4138.08,114,2,4,4,10,High-Value
15003,2010-08-23 15:44:00,6,1027.03,472,1,3,3,7,At-Risk
15004,2011-07-15 14:05:00,1,1220.38,146,2,1,3,6,Other
15005,2011-11-24 12:25:00,56,13752.58,14,4,4,4,12,High-Value
15006,2011-10-19 15:08:00,2,752.83,50,3,2,2,7,Other
15007,2011-07-03 16:00:00,1,156.91,158,2,1,1,4,One-Time
15008,2010-08-16 13:09:00,2,360.0,479,1,2,2,5,At-Risk
15009,2011-11-27 13:35:00,3,1259.43,11,4,2,3,9,High-Value
15010,2011-11-04 12:42:00,1,308.94,34,3,1,1,5,One-Time
15011,2010-11-09 11:10:00,2,416.6,394,1,2,2,5,At-Risk
15012,2011-10-17 12:22:00,3,646.26,52,3,2,2,7,Other
15013,2010-08-09 12:05:00,10,1610.82,486,1,4,3,8,At-Risk
15014,2011-10-27 20:07:00,2,257.67,42,3,2,1,6,Other
15015,2010-07-26 13:50:00,13,2344.47,500,1,4,4,9,High-Value
15016,2011-06-20 12:06:00,5,620.89,171,2,3,2,7,Other
15017,2011-11-06 10:33:00,1,125.58,32,3,1,1,5,One-Time
15018,2011-11-01 12:47:00,3,496.21,37,3,2,2,7,Other
15019,2011-03-18 12:35:00,1,252.81,265,2,1,1,4,One-Time
15020,2010-11-25 13:29:00,1,198.47,378,2,1,1,4,One-Time
15021,2011-12-01 11:53:00,12,2500.59,7,4,4,4,12,High-Value
15022,2011-11-28 12:35:00,5,1133.44,10,4,3,3,10,High-Value
15023,2011-12-06 17:23:00,20,11555.5,2,4,4,4,12,High-Value
15024,2011-11-30 12:06:00,16,3559.39,8,4,4,4,12,High-Value
15025,2011-11-06 15:20:00,2,971.84,32,3,2,3,8,Other
15026,2011-09-20 13:52:00,5,1044.09,79,3,3,3,9,High-Value
15027,2011-11-09 10:16:00,10,3195.6,29,3,4,4,11,High-Value
15028,2011-12-01 14:06:00,6,962.94,7,4,3,3,10,High-Value
15029,2010-03-30 12:16:00,1,365.1,618,1,1,2,4,At-Risk
15030,2011-09-29 10:50:00,8,1979.91,70,3,4,3,10,High-Value
15031,2011-12-05 14:19:00,14,3102.94,3,4,4,4,12,High-Value
15032,2011-03-28 15:03:00,8,11010.05,255,2,4,4,10,High-Value
15033,2011-12-05 12:40:00,10,2553.88,3,4,4,4,12,High-Value
15034,2011-11-24 12:11:00,14,8231.2,14,4,4,4,12,High-Value
15035,2011-09-11 11:08:00,1,252.73,88,3,1,1,5,One-Time
15036,2011-09-28 15:42:00,3,429.56,71,3,2,2,7,Other
15037,2010-11-28 13:05:00,2,397.76,375,2,2,2,6,Other
15038,2011-10-12 11:33:00,9,1146.53,57,3,4,3,10,High-Value
15039,2011-11-30 11:31:00,93,39141.48,8,4,4,4,12,High-Value
15040,2010-06-16 11:40:00,1,7.49,540,1,1,1,3,At-Risk
15041,2011-06-22 16:16:00,2,288.98,169,2,2,1,5,Other
15042,2011-05-24 16:25:00,2,315.45,198,2,2,1,5,Other
15043,2011-11-08 14:26:00,6,2855.32,30,3,3,4,10,High-Value
15044,2011-11-20 13:20:00,32,15769.01,18,4,4,4,12,High-Value
15045,2011-07-11 11:33:00,2,735.66,150,2,2,2,6,Other
15046,2011-11-30 15:50:00,25,7604.84,8,4,4,4,12,High-Value
15047,2011-03-15 10:49:00,1,343.62,268,2,1,2,5,Other
15048,2011-10-05 14:55:00,4,381.0,64,3,3,2,8,Loyal
15049,2011-03-11 12:13:00,1,121.17,272,2,1,1,4,One-Time
15050,2011-11-14 16:17:00,5,4087.19,24,4,3,4,11,High-Value
15051,2011-11-16 15:38:00,9,3926.91,22,4,4,4,12,High-Value
15052,2011-01-24 15:52:00,1,207.73,318,2,1,1,4,One-Time
15053,2011-12-05 12:08:00,3,693.95,3,4,2,2,8,Other
15054,2011-11-27 15:02:00,2,302.1,11,4,2,1,7,Other
15055,2010-08-22 11:06:00,3,549.12,473,1,2,2,5,At-Risk
15056,2010-07-07 15:58:00,1,113.65,519,1,1,1,3,At-Risk
15057,2011-03-09 15:17:00,5,3255.96,274,2,3,4,9,High-Value
15058,2011-11-14 14:57:00,16,3387.58,24,4,4,4,12,High-Value
15059,2011-10-30 11:35:00,19,3490.4,39,3,4,4,11,High-Value
15060,2011-12-01 13:47:00,4,293.0,7,4,3,1,8,Loyal
15061,2011-12-06 12:06:00,127,126387.57,2,4,4,4,12,High-Value
15062,2011-09-29 16:51:00,8,2585.62,70,3,4,4,11,High-Value
15063,2011-05-10 13:25:00,1,370.8,212,2,1,2,5,Other
15064,2010-10-25 14:32:00,4,1154.41,409,1,3,3,7,At-Risk
15065,2011-11-02 09:45:00,5,3326.86,36,3,3,4,10,High-Value
15066,2011-10-17 13:25:00,1,893.59,52,3,1,3,7,Other
15067,2011-09-22 13:20:00,5,3862.88,77,3,3,4,10,High-Value
15068,2011-10-24 14:47:00,4,1174.9,45,3,3,3,9,High-Value
15069,2011-06-13 14:16:00,1,1109.53,178,2,1,3,6,Other
15070,2010-12-02 11:23:00,3,737.05,371,2,2,2,6,Other
15071,2011-09-07 11:43:00,4,1455.56,92,3,3,3,9,High-Value
15072,2010-08-17 15:46:00,1,187.52,478,1,1,1,3,At-Risk
15073,2011-11-30 10:44:00,8,2788.02,8,4,4,4,12,High-Value
15074,2011-08-26 14:45:00,3,1553.13,104,2,2,3,7,Other
15075,2011-09-23 12:27:00,1,773.03,76,3,1,2,6,Other
15076,2011-06-20 08:23:00,3,1447.74,171,2,2,3,7,Other
15077,2010-08-02 11:13:00,2,2428.08,493,1,2,4,7,At-Risk
15078,2011-12-02 15:41:00,52,17276.73,6,4,4,4,12,High-Value
15079,2011-05-11 12:45:00,11,3625.4,211,2,4,4,10,High-Value
15080,2010-10-08 11:52:00,2,546.25,426,1,2,2,5,At-Risk
15081,2011-11-17 17:08:00,12,1854.57,21,4,4,3,11,High-Value
15082,2010-02-09 10:23:00,1,93.35,667,1,1,1,3,At-Risk
15083,2011-03-28 12:18:00,1,88.2,255,2,1,1,4,One-Time
15084,2010-11-25 11:58:00,2,965.2,378,2,2,3,7,Other
15085,2009-12-10 11:47:00,1,347.54,728,1,1,2,4,At-Risk
15086,2010-05-24 12:27:00,2,218.53,563,1,2,1,4,At-Risk
15087,2011-03-03 10:34:00,1,306.94,280,2,1,1,4,One-Time
15088,2011-11-18 13:14:00,2,1160.07,20,4,2,3,9,High-Value
15089,2011-11-29 16:31:00,6,2420.84,9,4,3,4,11,High-Value
15090,2011-02-04 14:03:00,1,381.32,307,2,1,2,5,Other
15091,2011-10-03 12:47:00,3,1046.61,66,3,2,3,8,Other
15092,2011-05-08 14:10:00,3,776.46,214,2,2,2,6,Other
15093,2011-11-21 13:09:00,23,13702.38,17,4,4,4,12,High-Value
15094,2010-09-02 16:55:00,2,83.0,462,1,2,1,4,At-Risk
15095,2011-08-28 12:01:00,10,3141.64,102,2,4,4,10,High-Value
15096,2011-10-28 10:27:00,1,219.39,41,3,1,1,5,One-Time
15097,2011-12-05 14:03:00,3,908.35,3,4,2,3,9,High-Value
15098,2011-06-10 15:33:00,3,39916.5,181,2,2,4,8,Other
15099,2011-09-16 13:13:00,1,410.48,83,3,1,2,6,Other
15100,2011-01-10 10:35:00,7,2193.9,332,2,4,3,9,High-Value
15101,2011-12-01 10:18:00,6,1477.94,7,4,3,3,10,High-Value
15102,2010-06-27 12:16:00,2,554.67,529,1,2,2,5,At-Risk
15103,2011-11-08 14:53:00,2,703.36,30,3,2,2,7,Other
15104,2011-05-27 12:29:00,2,993.54,195,2,2,3,7,Other
15105,2011-11-21 16:54:00,9,3094.91,17,4,4,4,12,High-Value
15106,2011-11-22 09:16:00,5,1422.52,16,4,3,3,10,High-Value
15107,2011-02-01 14:46:00,9,824.35,310,2,4,2,8,Other
15108,2011-07-21 10:24:00,3,1159.25,140,2,2,3,7,Other
15109,2011-04-08 09:58:00,3,983.1,244,2,2,3,7,Other
15110,2011-11-16 11:16:00,6,1505.85,22,4,3,3,10,High-Value
15111,2011-11-10 16:58:00,5,2442.37,28,3,3,4,10,High-Value
15112,2010-04-07 14:17:00,1,209.4,610,1,1,1,3,At-Risk
15113,2011-11-30 08:23:00,3,3509.04,8,4,2,4,10,High-Value
15114,2011-11-09 15:05:00,12,3400.12,29,3,4,4,11,High-Value
15115,2011-11-21 14:59:00,2,531.85,17,4,2,2,8,Other
15116,2011-11-22 12:25:00,4,1352.75,16,4,3,3,10,High-Value
15117,2011-11-25 08:12:00,8,2485.97,13,4,4,4,12,High-Value
15118,2011-07-28 14:54:00,1,244.8,133,2,1,1,4,One-Time
15119,2011-04-08 09:08:00,1,266.4,244,2,1,1,4,One-Time
15120,2011-07-29 09:48:00,1,358.82,132,2,1,2,5,Other
15121,2011-10-20 14:51:00,2,457.72,49,3,2,2,7,Other
15122,2011-08-17 16:48:00,11,4487.27,113,2,4,4,10,High-Value
15123,2011-12-02 13:12:00,5,4656.17,6,4,3,4,11,High-Value
15124,2011-11-17 10:09:00,4,450.82,21,4,3,2,9,High-Value
15125,2011-11-14 13:57:00,24,17024.87,24,4,4,4,12,High-Value
15126,2010-06-21 12:31:00,2,449.49,535,1,2,2,5,At-Risk
15127,2011-10-05 10:30:00,2,711.5,64,3,2,2,7,Other
15128,2011-10-10 13:54:00,5,1783.68,59,3,3,3,9,High-Value
15129,2011-10-20 14:40:00,23,6860.18,49,3,4,4,11,High-Value
15130,2011-06-23 10:15:00,1,330.11,168,2,1,1,4,One-Time
15131,2010-11-10 12:07:00,1,80.28,393,1,1,1,3,At-Risk
15132,2011-11-21 17:10:00,5,977.93,17,4,3,3,10,High-Value
15133,2011-08-04 10:44:00,5,1806.9,126,2,3,3,8,Other
15134,2011-11-25 08:55:00,10,1596.29,13,4,4,3,11,High-Value
15135,2011-04-14 19:16:00,2,305.68,238,2,2,1,5,Other
15136,2011-12-07 12:26:00,4,1286.7,1,4,3,3,10,High-Value
15137,2010-07-07 09:41:00,2,823.4,519,1,2,2,5,At-Risk
15138,2010-11-11 09:16:00,1,502.52,392,1,1,2,4,At-Risk
15139,2011-04-14 11:39:00,2,178.96,238,2,2,1,5,Other
15140,2011-10-18 14:07:00,8,3243.69,51,3,4,4,11,High-Value
15141,2010-09-08 11:33:00,7,1388.47,456,1,4,3,8,At-Risk
15142,2011-10-24 12:51:00,6,2619.92,45,3,3,4,10,High-Value
15143,2011-04-28 12:03:00,2,563.63,224,2,2,2,6,Other
15144,2011-12-01 15:12:00,29,12160.31,7,4,4,4,12,High-Value
15145,2011-12-05 17:21:00,4,1194.73,3,4,3,3,10,High-Value
15146,2011-06-28 12:09:00,2,1327.16,163,2,2,3,7,Other
15147,2011-04-13 15:57:00,1,623.5,239,2,1,2,5,Other
15148,2011-11-29 08:21:00,1,301.29,9,4,1,1,6,One-Time
15149,2011-07-29 10:58:00,4,1524.61,132,2,3,3,8,Other
15150,2011-11-22 12:52:00,13,8977.94,16,4,4,4,12,High-Value
15151,2010-10-12 16:37:00,2,2085.61,422,1,2,3,6,At-Risk
15152,2011-11-30 12:32:00,14,5263.83,8,4,4,4,12,High-Value
15153,2011-11-08 17:09:00,1,329.25,30,3,1,1,5,One-Time
15154,2011-09-25 16:05:00,3,1343.72,74,3,2,3,8,Other
15155,2010-11-21 12:59:00,1,383.97,382,1,1,2,4,At-Risk
15156,2011-12-08 18:22:00,3,961.49,0,4,2,3,9,High-Value
15157,2011-12-06 11:28:00,5,2654.11,2,4,3,4,11,High-Value
15158,2011-10-25 13:53:00,2,606.02,44,3,2,2,7,Other
15159,2011-12-08 12:05:00,34,22116.73,0,4,4,4,12,High-Value
15160,2010-12-17 14:15:00,4,589.27,356,2,3,2,7,Other
15161,2010-11-16 16:08:00,1,119.92,387,1,1,1,3,At-Risk
15162,2009-12-08 13:14:00,1,312.9,730,1,1,1,3,At-Risk
15163,2011-11-21 13:10:00,2,304.47,17,4,2,1,7,Other
15164,2011-10-02 12:05:00,9,2028.11,67,3,4,3,10,High-Value
15165,2010-12-01 14:03:00,1,487.75,372,2,1,2,5,Other
15166,2010-08-29 12:31:00,1,167.16,466,1,1,1,3,At-Risk
15167,2011-01-23 12:41:00,5,1627.62,319,2,3,3,8,Other
15168,2011-11-14 11:26:00,1,106.56,24,4,1,1,6,One-Time
15169,2010-11-22 13:04:00,2,569.22,381,1,2,2,5,At-Risk
15170,2010-10-29 10:34:00,1,81.15,405,1,1,1,3,At-Risk
15171,2011-01-12 15:36:00,1,1289.5,330,2,1,3,6,Other
15172,2011-12-01 11:51:00,5,1624.05,7,4,3,3,10,High-Value
15173,2010-11-24 10:21:00,7,1494.6,379,1,4,3,8,At-Risk
15174,2011-01-21 09:06:00,2,481.46,321,2,2,2,6,Other
15175,2011-09-29 11:31:00,1,224.14,70,3,1,1,5,One-Time
15176,2010-02-10 10:36:00,1,988.04,666,1,1,3,5,At-Risk
15177,2010-10-10 12:48:00,1,948.93,424,1,1,3,5,At-Risk
15178,2011-03-24 15:12:00,1,40.5,259,2,1,1,4,One-Time
15179,2011-11-21 12:53:00,13,7491.92,17,4,4,4,12,High-Value
15180,2010-12-07 14:57:00,3,816.93,366,2,2,2,6,Other
15181,2011-10-04 13:58:00,5,1200.2,65,3,3,3,9,High-Value
15182,2011-07-08 13:37:00,11,2998.95,153,2,4,4,10,High-Value
15183,2010-06-10 10:43:00,3,639.93,546,1,2,2,5,At-Risk
15184,2011-11-10 13:41:00,4,685.39,28,3,3,2,8,Loyal
15185,2011-09-30 14:06:00,1,310.62,69,3,1,1,5,One-Time
15186,2011-11-25 14:58:00,5,1403.2,13,4,3,3,10,High-Value
15187,2011-12-08 11:56:00,15,4762.18,0,4,4,4,12,High-Value
15188,2009-12-14 13:30:00,1,310.43,724,1,1,1,3,At-Risk
15189,2011-12-08 13:22:00,46,17524.38,0,4,4,4,12,High-Value
15190,2010-10-01 13:09:00,1,834.44,433,1,1,2,4,At-Risk
15191,2010-09-02 15:37:00,3,588.05,462,1,2,2,5,At-Risk
15192,2011-08-12 11:41:00,5,1666.39,118,2,3,3,8,Other
15193,2011-10-10 08:23:00,1,499.32,59,3,1,2,6,Other
15194,2011-12-06 15:10:00,28,12021.53,2,4,4,4,12,High-Value
15195,2011-12-07 12:20:00,1,3861.0,1,4,1,4,9,High-Value
15196,2010-10-03 10:50:00,2,313.7,431,1,2,1,4,At-Risk
15197,2011-11-29 10:00:00,6,1877.51,9,4,3,3,10,High-Value
15198,2011-09-08 14:42:00,5,571.35,91,3,3,2,8,Loyal
15199,2011-10-11 15:12:00,10,3122.4,58,3,4,4,11,High-Value
15200,2010-08-02 09:38:00,1,549.05,493,1,1,2,4,At-Risk
15201,2011-09-13 14:53:00,7,1842.95,86,3,4,3,10,High-Value
15203,2011-11-14 08:16:00,15,4400.18,24,4,4,4,12,High-Value
15204,2010-12-17 13:49:00,1,316.58,356,2,1,1,4,One-Time
15205,2011-09-15 19:36:00,2,653.24,84,3,2,2,7,Other
15206,2011-11-29 13:41:00,4,420.3,9,4,3,2,9,High-Value
15207,2010-10-19 13:29:00,3,683.92,415,1,2,2,5,At-Risk
15208,2011-12-08 17:24:00,6,970.52,0,4,3,3,10,High-Value
15209,2009-12-09 17:26:00,1,178.98,729,1,1,1,3,At-Risk
15210,2011-04-28 16:11:00,3,1176.19,224,2,2,3,7,Other
15211,2011-10-10 13:31:00,2,894.41,59,3,2,3,8,Other
15212,2011-04-12 13:45:00,2,208.28,240,2,2,1,5,Other
15213,2011-01-25 12:21:00,2,328.35,317,2,2,1,5,Other
15214,2011-12-08 12:07:00,8,1661.44,0,4,4,3,11,High-Value
15215,2011-10-24 11:41:00,7,2422.43,45,3,4,4,11,High-Value
15216,2011-09-13 11:41:00,2,486.09,86,3,2,2,7,Other
15217,2010-05-25 13:51:00,1,426.24,562,1,1,2,4,At-Risk
15218,2011-11-29 11:48:00,22,11453.83,9,4,4,4,12,High-Value
15219,2011-06-16 16:57:00,2,685.45,175,2,2,2,6,Other
15220,2011-10-19 12:39:00,6,1778.96,50,3,3,3,9,High-Value
15221,2010-12-08 13:08:00,4,2062.2,365,2,3,3,8,Other
15222,2011-01-25 08:03:00,11,3550.91,317,2,4,4,10,High-Value
15223,2011-04-28 11:31:00,5,1417.95,224,2,3,3,8,Other
15224,2010-12-16 15:02:00,5,871.36,357,2,3,3,8,Other
15225,2011-04-19 14:51:00,1,409.4,233,2,1,2,5,Other
15226,2011-02-02 11:41:00,1,154.41,309,2,1,1,4,One-Time
15227,2011-11-03 11:59:00,9,2488.49,35,3,4,4,11,High-Value
15228,2011-10-04 13:56:00,6,5580.27,65,3,3,4,10,High-Value
15229,2010-05-02 13:50:00,1,160.5,585,1,1,1,3,At-Risk
15230,2011-04-14 14:39:00,2,429.6,238,2,2,2,6,Other
15231,2010-03-28 15:12:00,1,250.26,620,1,1,1,3,At-Risk
15232,2011-08-18 16:27:00,2,612.06,112,2,2,2,6,Other
15233,2010-11-03 13:36:00,1,59.4,400,1,1,1,3,At-Risk
15234,2011-03-08 08:53:00,1,197.0,275,2,1,1,4,One-Time
15235,2011-05-06 09:44:00,16,2772.76,216,2,4,4,10,High-Value
15236,2011-02-14 10:52:00,1,321.05,297,2,1,1,4,One-Time
15237,2011-12-08 09:46:00,4,1412.32,0,4,3,3,10,High-Value
15238,2011-11-10 14:28:00,3,1071.99,28,3,2,3,8,Other
15239,2011-11-29 14:14:00,2,780.59,9,4,2,2,8,Other
15240,2011-10-26 09:50:00,12,4459.98,43,3,4,4,11,High-Value
15241,2011-10-04 09:05:00,11,3050.16,65,3,4,4,11,High-Value
15242,2010-10-13 15:33:00,1,302.04,421,1,1,1,3,At-Risk
15243,2011-09-26 14:12:00,2,927.28,73,3,2,3,8,Other
15244,2011-10-05 13:19:00,3,912.08,64,3,2,3,8,Other
15245,2011-07-28 18:56:00,8,4610.84,133,2,4,4,10,High-Value
15246,2011-04-15 14:45:00,3,780.4,237,2,2,2,6,Other
15247,2011-08-09 12:52:00,3,976.06,121,2,2,3,7,Other
15248,2010-10-24 13:09:00,3,1893.93,410,1,2,3,6,At-Risk
15249,2011-11-08 11:45:00,18,9266.0,30,3,4,4,11,High-Value
15250,2010-03-09 07:35:00,1,60.0,639,1,1,1,3,At-Risk
15251,2011-11-30 15:02:00,21,20324.54,8,4,4,4,12,High-Value
15252,2011-11-03 13:30:00,5,2103.41,35,3,3,3,9,High-Value
15253,2011-11-23 16:22:00,8,2055.09,15,4,4,3,11,High-Value
15254,2011-08-04 15:04:00,3,1088.35,126,2,2,3,7,Other
15255,2011-10-04 12:43:00,9,3706.02,65,3,4,4,11,High-Value
15256,2011-07-14 11:47:00,2,170.4,147,2,2,1,5,Other
15257,2011-03-01 12:58:00,2,685.9,282,2,2,2,6,Other
15258,2011-06-24 12:30:00,2,623.16,167,2,2,2,6,Other
15259,2010-07-15 08:47:00,4,1182.38,511,1,3,3,7,At-Risk
15260,2011-08-31 13:55:00,25,8767.73,99,2,4,4,10,High-Value
15261,2011-07-27 15:20:00,4,1508.0,134,2,3,3,8,Other
15262,2011-01-20 12:16:00,3,418.82,322,2,2,2,6,Other
15263,2011-08-25 10:26:00,1,156.51,105,2,1,1,4,One-Time
15264,2011-10-06 13:49:00,2,848.4,63,3,2,2,7,Other
15265,2011-07-11 14:46:00,4,3345.64,150,2,3,4,9,High-Value
15266,2011-01-05 13:40:00,5,852.21,337,2,3,2,7,Other
15267,2011-11-17 15:59:00,5,1717.36,21,4,3,3,10,High-Value
15268,2010-08-18 10:33:00,3,961.9,477,1,2,3,6,At-Risk
15269,2011-11-16 09:32:00,3,1225.36,22,4,2,3,9,High-Value
15270,2011-11-24 09:24:00,21,8524.86,14,4,4,4,12,High-Value
15271,2011-12-02 14:11:00,24,4528.54,6,4,4,4,12,High-Value
15272,2011-10-13 12:59:00,6,2030.95,56,3,3,3,9,High-Value
15273,2010-04-19 11:31:00,1,228.96,598,1,1,1,3,At-Risk
15274,2011-12-05 16:57:00,2,716.57,3,4,2,2,8,Other
15275,2011-11-02 11:20:00,1,615.14,36,3,1,2,6,Other
15276,2011-10-04 16:39:00,4,619.8,65,3,3,2,8,Loyal
15277,2011-10-24 10:08:00,2,476.34,45,3,2,2,7,Other
15278,2010-05-27 10:03:00,4,496.16,560,1,3,2,6,At-Risk
15279,2010-12-20 10:48:00,5,1580.54,353,2,3,3,8,Other
15280,2011-06-20 17:14:00,3,397.52,171,2,2,2,6,Other
15281,2011-10-12 09:10:00,16,8543.57,57,3,4,4,11,High-Value
15282,2010-05-18 16:27:00,1,348.59,569,1,1,2,4,At-Risk
15283,2010-11-14 14:54:00,3,148.33,389,1,2,1,4,At-Risk
15284,2010-07-27 13:25:00,1,24.75,499,1,1,1,3,At-Risk
15285,2010-10-28 09:46:00,1,94.92,406,1,1,1,3,At-Risk
15286,2011-10-21 11:08:00,1,240.55,48,3,1,1,5,One-Time
15287,2011-11-17 15:34:00,5,856.03,21,4,3,3,10,High-Value
15288,2011-10-27 16:58:00,10,3706.53,42,3,4,4,11,High-Value
15289,2011-11-10 13:49:00,5,1593.09,28,3,3,3,9,High-Value
15290,2011-12-05 11:39:00,26,10496.28,3,4,4,4,12,High-Value
15291,2011-11-14 11:02:00,39,13472.76,24,4,4,4,12,High-Value
15292,2011-05-22 15:00:00,1,178.39,200,2,1,1,4,One-Time
15293,2010-02-12 11:54:00,1,247.5,664,1,1,1,3,At-Risk
15294,2010-10-25 11:45:00,1,233.35,409,1,1,1,3,At-Risk
15295,2010-02-23 13:03:00,1,207.04,653,1,1,1,3,At-Risk
15296,2011-10-20 11:47:00,12,10323.03,49,3,4,4,11,High-Value
15297,2011-11-29 16:32:00,3,641.94,9,4,2,2,8,Other
15298,2011-12-07 17:17:00,23,9061.77,1,4,4,4,12,High-Value
15299,2011-10-03 14:19:00,9,5556.53,66,3,4,4,11,High-Value
15300,2011-10-06 17:08:00,1,496.44,63,3,1,2,6,Other
15301,2011-10-20 09:57:00,17,6909.67,49,3,4,4,11,High-Value
15302,2009-12-09 13:11:00,1,308.0,729,1,1,1,3,At-Risk
15303,2011-02-22 13:59:00,3,1224.18,289,2,2,3,7,Other
15304,2011-10-10 10:23:00,9,796.4,59,3,4,2,9,High-Value
15305,2010-06-02 13:50:00,1,93.6,554,1,1,1,3,At-Risk
15306,2011-10-06 12:56:00,9,3484.73,63,3,4,4,11,High-Value
15307,2011-09-05 11:38:00,1,205.3,94,3,1,1,5,One-Time
15308,2011-03-10 13:08:00,1,310.47,273,2,1,1,4,One-Time
15309,2010-04-08 11:11:00,4,797.96,609,1,3,2,6,At-Risk
15310,2010-08-18 11:38:00,1,1634.64,477,1,1,3,5,At-Risk
15311,2011-12-09 12:00:00,207,114671.42,-1,4,4,4,12,High-Value
15312,2011-09-25 13:10:00,12,2930.19,74,3,4,4,11,High-Value
15313,2011-08-21 16:02:00,1,52.0,109,2,1,1,4,One-Time
15314,2011-05-24 14:39:00,3,820.45,198,2,2,2,6,Other
15315,2011-10-06 12:51:00,2,570.5,63,3,2,2,7,Other
15316,2011-01-17 11:34:00,1,165.0,325,2,1,1,4,One-Time
15317,2010-01-31 15:55:00,1,129.75,676,1,1,1,3,At-Risk
15318,2011-12-06 11:30:00,1,312.62,2,4,1,1,6,One-Time
15319,2011-03-01 12:48:00,1,204.5,282,2,1,1,4,One-Time
15320,2011-10-26 13:27:00,1,267.13,43,3,1,1,5,One-Time
15321,2011-09-30 09:40:00,12,6709.73,69,3,4,4,11,High-Value
15322,2011-09-15 09:34:00,2,1390.86,84,3,2,3,8,Other
15323,2010-05-26 10:01:00,3,434.6,561,1,2,2,5,At-Risk
15324,2010-01-07 14:37:00,1,140.22,700,1,1,1,3,At-Risk
15325,2011-08-28 11:55:00,8,1601.46,102,2,4,3,9,High-Value
15326,2011-01-10 11:38:00,5,1700.52,332,2,3,3,8,Other
15327,2011-10-18 11:55:00,1,208.75,51,3,1,1,5,One-Time
15328,2010-10-28 09:05:00,1,107.24,406,1,1,1,3,At-Risk
15329,2011-10-31 15:36:00,11,2958.83,38,3,4,4,11,High-Value
15330,2011-11-07 17:50:00,2,714.96,31,3,2,2,7,Other
15331,2010-07-28 09:42:00,3,767.91,498,1,2,2,5,At-Risk
15332,2010-12-08 14:43:00,6,4892.68,365,2,3,4,9,High-Value
15333,2011-05-15 13:27:00,1,1028.56,207,2,1,3,6,Other
15334,2011-07-06 11:22:00,3,347.87,155,2,2,2,6,Other
15335,2011-10-17 12:50:00,1,170.22,52,3,1,1,5,One-Time
15336,2010-11-03 12:39:00,1,240.5,400,1,1,1,3,At-Risk
15337,2010-10-24 15:29:00,1,373.02,410,1,1,2,4,At-Risk
15338,2010-01-31 14:25:00,1,277.93,676,1,1,1,3,At-Risk
15339,2011-10-04 12:51:00,7,1821.02,65,3,4,3,10,High-Value
15340,2010-05-27 10:27:00,1,105.5,560,1,1,1,3,At-Risk
15341,2011-09-20 09:40:00,2,2402.72,79,3,2,4,9,High-Value
15342,2011-08-02 10:19:00,1,406.09,128,2,1,2,5,Other
15343,2011-09-13 13:55:00,1,364.5,86,3,1,2,6,Other
15344,2011-12-09 10:45:00,3,563.94,-1,4,2,2,8,Other
15345,2011-10-25 11:28:00,1,393.54,44,3,1,2,6,Other
15346,2011-01-11 11:18:00,3,596.12,331,2,2,2,6,Other
15347,2010-12-08 15:25:00,4,1162.0,365,2,3,3,8,Other
15348,2011-09-28 13:17:00,1,158.04,71,3,1,1,5,One-Time
15349,2011-07-04 16:06:00,2,463.91,157,2,2,2,6,Other
15350,2010-12-01 13:33:00,2,547.6,372,2,2,2,6,Other
15351,2011-11-27 12:52:00,10,3430.22,11,4,4,4,12,High-Value
15352,2010-06-09 11:28:00,1,111.15,547,1,1,1,3,At-Risk
15353,2011-03-30 12:15:00,7,2794.47,253,2,4,4,10,High-Value
15355,2011-11-10 13:44:00,2,277.05,28,3,2,1,6,Other
15356,2011-11-08 13:11:00,13,3239.57,30,3,4,4,11,High-Value
15358,2011-12-05 09:04:00,42,16425.86,3,4,4,4,12,High-Value
15359,2010-02-15 10:47:00,8,181.35,661,1,4,1,6,At-Risk
15360,2011-10-31 09:35:00,1,427.93,38,3,1,2,6,Other
15361,2010-12-13 09:52:00,4,689.07,360,2,3,2,7,Other
15362,2010-09-17 10:37:00,2,613.08,447,1,2,2,5,At-Risk
15363,2010-12-02 12:28:00,2,678.11,371,2,2,2,6,Other
15364,2011-09-05 09:46:00,2,913.19,94,3,2,3,8,Other
15365,2011-11-14 08:29:00,13,4557.13,24,4,4,4,12,High-Value
15366,2011-09-25 15:01:00,7,2389.08,74,3,4,4,11,High-Value
15367,2011-10-13 14:13:00,11,5081.33,56,3,4,4,11,High-Value
15368,2011-11-18 14:42:00,2,722.74,20,4,2,2,8,Other
15369,2010-08-04 13:54:00,11,6251.26,491,1,4,4,9,High-Value
15370,2011-10-30 10:58:00,8,3739.01,39,3,4,4,11,High-Value
15371,2010-02-15 13:14:00,1,59.4,661,1,1,1,3,At-Risk
15372,2011-07-25 16:39:00,8,6017.06,136,2,4,4,10,High-Value
15373,2011-12-01 15:05:00,17,3084.54,7,4,4,4,12,High-Value
15374,2011-08-03 09:59:00,2,307.32,127,2,2,1,5,Other
15375,2010-01-18 15:38:00,1,60.96,689,1,1,1,3,At-Risk
15376,2011-10-30 15:04:00,3,1221.56,39,3,2,3,8,Other
15377,2010-11-22 08:55:00,4,1211.75,381,1,3,3,7,At-Risk
15378,2010-09-03 11:30:00,2,246.5,461,1,2,1,4,At-Risk
15379,2011-06-23 13:13:00,8,4877.84,168,2,4,4,10,High-Value
15380,2011-12-01 12:13:00,11,3248.96,7,4,4,4,12,High-Value
15381,2011-05-10 11:55:00,5,1890.57,212,2,3,3,8,Other
15382,2011-11-25 10:58:00,12,13733.55,13,4,4,4,12,High-Value
15384,2011-06-23 10:57:00,4,2027.79,168,2,3,3,8,Other
15385,2011-10-30 15:11:00,3,942.08,39,3,2,3,8,Other
15386,2011-06-06 13:47:00,1,394.14,185,2,1,2,5,Other
15387,2010-08-04 16:05:00,1,468.65,491,1,1,2,4,At-Risk
15388,2011-03-14 13:53:00,1,140.54,269,2,1,1,4,One-Time
15389,2011-06-20 16:18:00,5,2733.8,171,2,3,4,9,High-Value
15390,2010-11-08 15:19:00,2,1216.66,395,1,2,3,6,At-Risk
15391,2010-05-04 15:04:00,1,289.87,583,1,1,1,3,At-Risk
15392,2011-12-05 11:01:00,7,2911.62,3,4,4,4,12,High-Value
15393,2011-11-23 16:48:00,5,891.34,15,4,3,3,10,High-Value
15394,2011-11-30 11:49:00,11,5286.8,8,4,4,4,12,High-Value
15395,2011-01-18 12:40:00,1,107.45,324,2,1,1,4,One-Time
15396,2011-08-19 10:56:00,2,796.38,111,2,2,2,6,Other
15397,2011-02-23 09:25:00,1,94.0,288,2,1,1,4,One-Time
15398,2011-11-23 16:47:00,2,1345.53,15,4,2,3,9,High-Value
15399,2011-12-08 13:04:00,3,815.77,0,4,2,2,8,Other
15400,2011-09-08 13:57:00,8,1302.3,91,3,4,3,10,High-Value
15401,2010-09-13 13:42:00,2,216.95,451,1,2,1,4,At-Risk
15402,2011-07-14 12:17:00,6,1830.12,147,2,3,3,8,Other
15403,2010-08-05 12:21:00,2,170.88,490,1,2,1,4,At-Risk
15404,2010-11-29 11:03:00,1,257.06,374,2,1,1,4,One-Time
15405,2011-06-03 14:44:00,2,659.84,188,2,2,2,6,Other
15406,2011-11-08 13:22:00,4,975.87,30,3,3,3,9,High-Value
15407,2011-11-06 11:55:00,4,1046.74,32,3,3,3,9,High-Value
15408,2011-03-20 15:02:00,1,267.18,263,2,1,1,4,One-Time
15409,2009-12-18 15:35:00,1,131.25,720,1,1,1,3,At-Risk
15410,2011-09-16 14:47:00,10,4685.72,83,3,4,4,11,High-Value
15411,2011-11-13 15:19:00,4,1348.93,25,3,3,3,9,High-Value
15412,2011-06-21 15:24:00,1,190.53,170,2,1,1,4,One-Time
15413,2010-01-17 11:33:00,5,6798.72,690,1,3,4,8,At-Risk
15414,2011-11-30 09:50:00,3,774.9,8,4,2,2,8,Other
15415,2011-01-30 14:13:00,1,559.61,312,2,1,2,5,Other
15416,2011-10-06 09:38:00,7,4572.82,63,3,4,4,11,High-Value
15417,2011-09-15 15:26:00,1,508.8,84,3,1,2,6,Other
15418,2010-10-10 13:38:00,2,449.42,424,1,2,2,5,At-Risk
15419,2011-11-15 09:23:00,1,135.86,23,4,1,1,6,One-Time
15420,2010-10-01 15:46:00,6,743.0,433,1,3,2,6,At-Risk
15421,2011-10-12 09:20:00,10,3805.34,57,3,4,4,11,High-Value
15422,2011-01-20 16:17:00,7,1619.97,322,2,4,3,9,High-Value
15423,2011-11-01 14:01:00,3,266.89,37,3,2,1,6,Other
15424,2011-03-30 13:02:00,3,597.78,253,2,2,2,6,Other
15425,2010-11-04 18:13:00,4,1941.12,399,1,3,3,7,At-Risk
15426,2011-11-20 15:36:00,9,2156.35,18,4,4,3,11,High-Value
15427,2011-11-06 14:29:00,3,1430.54,32,3,2,3,8,Other
15428,2011-11-24 16:54:00,4,762.75,14,4,3,2,9,High-Value
15429,2011-11-13 12:28:00,2,397.35,25,3,2,2,7,Other
15430,2010-08-29 10:42:00,2,954.75,466,1,2,3,6,At-Risk
15431,2010-07-25 12:44:00,1,153.24,501,1,1,1,3,At-Risk
15432,2011-11-16 16:30:00,2,320.76,22,4,2,1,7,Other
15433,2011-05-10 10:45:00,2,533.3,212,2,2,2,6,Other
15434,2011-12-01 13:33:00,11,2567.06,7,4,4,4,12,High-Value
15435,2011-11-17 16:39:00,1,149.29,21,4,1,1,6,One-Time
15436,2011-11-27 16:05:00,3,1067.75,11,4,2,3,9,High-Value
15437,2011-03-22 13:11:00,2,393.45,261,2,2,2,6,Other
15438,2011-07-31 14:19:00,1,156.58,130,2,1,1,4,One-Time
15439,2010-10-31 10:38:00,4,1269.05,403,1,3,3,7,At-Risk
15440,2011-10-16 12:16:00,3,383.68,53,3,2,2,7,Other
15441,2010-11-08 15:50:00,3,1254.21,395,1,2,3,6,At-Risk
15442,2011-04-05 12:24:00,1,594.0,247,2,1,2,5,Other
15443,2011-12-08 10:40:00,14,5114.23,0,4,4,4,12,High-Value
15444,2011-11-30 17:37:00,2,1411.21,8,4,2,3,9,High-Value
15445,2011-03-20 15:06:00,2,284.5,263,2,2,1,5,Other
15446,2010-11-28 11:59:00,3,396.75,375,2,2,2,6,Other
15447,2011-01-13 11:26:00,5,492.88,329,2,3,2,7,Other
15448,2011-01-31 10:42:00,2,788.81,311,2,2,2,6,Other
15449,2011-11-13 15:02:00,3,974.52,25,3,2,3,8,Other
15450,2011-11-09 17:11:00,1,429.84,29,3,1,2,6,Other
15451,2010-10-01 13:40:00,2,226.86,433,1,2,1,4,At-Risk
15452,2011-11-10 12:13:00,6,1785.11,28,3,3,3,9,High-Value
15453,2011-12-08 10:59:00,7,1371.77,0,4,4,3,11,High-Value
15454,2010-12-12 14:21:00,2,303.89,361,2,2,1,5,Other
15455,2010-04-21 12:43:00,1,38.25,596,1,1,1,3,At-Risk
15456,2011-03-01 13:51:00,10,2091.52,282,2,4,3,9,High-Value
15457,2011-03-22 15:31:00,1,237.07,261,2,1,1,4,One-Time
15458,2011-11-14 13:08:00,2,370.44,24,4,2,2,8,Other
15459,2010-10-18 15:25:00,2,202.83,416,1,2,1,4,At-Risk
15460,2010-12-20 16:08:00,1,214.26,353,2,1,1,4,One-Time
15461,2010-09-05 12:31:00,2,429.7,459,1,2,2,5,At-Risk
15462,2011-09-06 13:11:00,4,737.05,93,3,3,2,8,Loyal
15463,2011-11-10 12:57:00,1,126.14,28,3,1,1,5,One-Time
15464,2011-01-05 15:56:00,1,1044.65,337,2,1,3,6,Other
15465,2011-11-20 10:11:00,32,12100.4,18,4,4,4,12,High-Value
15466,2011-09-15 14:08:00,4,1560.46,84,3,3,3,9,High-Value
15467,2011-11-30 14:17:00,3,524.88,8,4,2,2,8,Other
15468,2011-10-19 13:49:00,3,1430.48,50,3,2,3,8,Other
15469,2011-10-20 16:21:00,3,874.25,49,3,2,3,8,Other
15470,2010-05-13 09:35:00,1,63.42,574,1,1,1,3,At-Risk
15471,2011-12-07 14:12:00,3,1292.01,1,4,2,3,9,High-Value
15472,2011-08-18 15:17:00,1,371.56,112,2,1,2,5,Other
15473,2011-11-25 15:15:00,8,2046.0,13,4,4,3,11,High-Value
15474,2010-04-23 11:14:00,1,150.35,594,1,1,1,3,At-Risk
15475,2011-09-23 15:20:00,1,454.11,76,3,1,2,6,Other
15476,2010-11-24 15:17:00,4,2209.98,379,1,3,3,7,At-Risk
15477,2010-02-28 10:37:00,1,368.4,648,1,1,2,4,At-Risk
15478,2011-10-30 14:19:00,3,1940.98,39,3,2,3,8,Other
15479,2009-12-06 15:08:00,1,147.4,732,1,1,1,3,At-Risk
15480,2011-08-15 14:32:00,3,3592.25,115,2,2,4,8,Other
15481,2010-11-03 14:52:00,1,1993.34,400,1,1,3,5,At-Risk
15482,2011-11-24 10:46:00,18,14377.36,14,4,4,4,12,High-Value
15483,2011-07-01 13:07:00,10,810.68,160,2,4,2,8,Other
15484,2011-12-08 15:03:00,6,4652.1,0,4,3,4,11,High-Value
15485,2011-11-09 14:31:00,7,4810.92,29,3,4,4,11,High-Value
15486,2010-06-30 13:15:00,1,102.0,526,1,1,1,3,At-Risk
15487,2010-01-29 12:07:00,1,231.32,678,1,1,1,3,At-Risk
15488,2011-09-08 10:11:00,5,431.92,91,3,3,2,8,Loyal
15489,2011-11-17 08:53:00,8,2419.61,21,4,4,4,12,High-Value
15490,2010-10-05 13:11:00,1,210.85,429,1,1,1,3,At-Risk
15491,2011-09-05 15:56:00,6,3100.09,94,3,3,4,10,High-Value
15492,2011-11-11 14:53:00,2,659.46,27,3,2,2,7,Other
15493,2011-11-07 12:04:00,9,4113.19,31,3,4,4,11,High-Value
15494,2011-11-18 14:51:00,5,3702.6,20,4,3,4,11,High-Value
15495,2010-11-25 13:46:00,1,246.5,378,2,1,1,4,One-Time
15496,2010-03-18 13:16:00,1,146.14,630,1,1,1,3,At-Risk
15497,2011-11-22 11:51:00,9,8657.39,16,4,4,4,12,High-Value
15498,2011-12-07 12:48:00,44,24972.86,1,4,4,4,12,High-Value
15499,2009-12-16 12:17:00,1,158.65,722,1,1,1,3,At-Risk
15500,2011-12-01 13:47:00,4,1131.56,7,4,3,3,10,High-Value
15501,2010-10-31 11:15:00,2,399.95,403,1,2,2,5,At-Risk
15502,2011-11-24 12:48:00,12,9542.92,14,4,4,4,12,High-Value
15503,2010-12-12 10:57:00,2,257.3,361,2,2,1,5,Other
15504,2011-09-19 13:45:00,4,391.45,80,3,3,2,8,Loyal
15505,2011-10-18 07:56:00,5,3610.96,51,3,3,4,10,High-Value
15506,2011-11-17 12:11:00,6,2030.33,21,4,3,3,10,High-Value
15507,2011-06-21 11:19:00,1,475.86,170,2,1,2,5,Other
15508,2011-06-03 15:43:00,6,1000.27,188,2,3,3,8,Other
15509,2010-11-24 14:48:00,1,152.41,379,1,1,1,3,At-Risk
15510,2011-01-13 12:10:00,1,250.0,329,2,1,1,4,One-Time
15511,2011-11-28 09:43:00,5,900.53,10,4,3,3,10,High-Value
15512,2011-07-07 10:20:00,4,331.58,154,2,3,1,6,Other
15513,2011-11-06 14:36:00,35,26437.05,32,3,4,4,11,High-Value
15514,2011-11-27 14:40:00,18,6388.28,11,4,4,4,12,High-Value
15515,2010-11-17 13:39:00,1,171.81,386,1,1,1,3,At-Risk
15516,2011-10-26 10:51:00,3,62.43,43,3,2,1,6,Other
15517,2011-04-20 14:02:00,1,267.03,232,2,1,1,4,One-Time
15518,2011-10-06 13:05:00,15,4189.99,63,3,4,4,11,High-Value
15519,2010-11-21 14:35:00,2,344.61,382,1,2,2,5,At-Risk
15520,2011-12-08 10:58:00,1,343.5,0,4,1,2,7,Other
15521,2011-10-30 13:42:00,16,7087.64,39,3,4,4,11,High-Value
15522,2011-11-07 11:26:00,2,397.99,31,3,2,2,7,Other
15523,2011-09-16 16:29:00,16,17259.19,83,3,4,4,11,High-Value
15524,2011-11-15 12:09:00,2,591.4,23,4,2,2,8,Other
15525,2011-12-07 14:43:00,4,887.72,1,4,3,3,10,High-Value
15526,2011-11-06 15:04:00,2,148.44,32,3,2,1,6,Other
15527,2011-11-21 12:17:00,23,5554.04,17,4,4,4,12,High-Value
15528,2011-03-30 16:14:00,1,229.33,253,2,1,1,4,One-Time
15529,2011-11-17 11:29:00,12,4781.11,21,4,4,4,12,High-Value
15530,2011-11-18 12:25:00,5,1808.68,20,4,3,3,10,High-Value
15531,2011-12-01 18:43:00,2,1972.39,7,4,2,3,9,High-Value
15532,2011-11-14 14:51:00,10,3717.2,24,4,4,4,12,High-Value
15533,2011-11-20 15:35:00,3,807.57,18,4,2,2,8,Other
15534,2009-12-14 12:48:00,1,162.25,724,1,1,1,3,At-Risk
15535,2011-06-19 16:02:00,6,1044.37,172,2,3,3,8,Other
15536,2010-10-26 16:31:00,1,259.09,408,1,1,1,3,At-Risk
15537,2011-06-29 13:10:00,1,110.92,162,2,1,1,4,One-Time
15538,2010-06-20 10:49:00,6,3358.4,536,1,3,4,8,At-Risk
15539,2011-12-02 13:36:00,1,538.46,6,4,1,2,7,Other
15540,2011-11-28 13:51:00,2,460.68,10,4,2,2,8,Other
15541,2011-08-17 14:58:00,1,85.13,113,2,1,1,4,One-Time
15542,2010-07-15 13:32:00,3,855.71,511,1,2,2,5,At-Risk
15543,2011-02-24 15:26:00,2,242.26,287,2,2,1,5,Other
15544,2011-11-30 16:43:00,20,7807.89,8,4,4,4,12,High-Value
15545,2011-10-16 13:24:00,2,288.97,53,3,2,1,6,Other
15546,2010-04-12 11:51:00,2,1079.1,605,1,2,3,6,At-Risk
15547,2011-12-02 12:52:00,26,10002.65,6,4,4,4,12,High-Value
15548,2010-04-23 12:20:00,1,158.09,594,1,1,1,3,At-Risk
15549,2011-09-23 16:22:00,8,2330.41,76,3,4,4,11,High-Value
15550,2011-12-05 15:38:00,12,2211.05,3,4,4,3,11,High-Value
15551,2011-11-03 12:37:00,7,1679.81,35,3,4,3,10,High-Value
15552,2011-05-06 14:47:00,2,252.52,216,2,2,1,5,Other
15553,2011-10-10 14:02:00,1,428.93,59,3,1,2,6,Other
15554,2011-03-07 09:00:00,1,217.2,276,2,1,1,4,One-Time
15555,2011-11-27 16:19:00,36,11233.78,11,4,4,4,12,High-Value
15556,2011-11-15 16:08:00,1,279.77,23,4,1,1,6,One-Time
15557,2011-11-11 12:46:00,1,468.91,27,3,1,2,6,Other
15558,2010-03-10 15:25:00,1,202.68,638,1,1,1,3,At-Risk
15559,2010-05-20 14:06:00,1,1109.4,567,1,1,3,5,At-Risk
15560,2010-11-07 10:15:00,2,153.52,396,1,2,1,4,At-Risk
15561,2011-11-28 11:07:00,8,1934.39,10,4,4,3,11,High-Value
15562,2010-12-23 09:55:00,3,671.43,350,2,2,2,6,Other
15563,2011-11-17 12:59:00,6,2820.46,21,4,3,4,11,High-Value
15564,2010-09-02 15:52:00,2,70.74,462,1,2,1,4,At-Risk
15565,2011-10-20 14:33:00,2,173.16,49,3,2,1,6,Other
15566,2010-11-12 12:11:00,2,227.87,391,1,2,1,4,At-Risk
15567,2011-11-21 10:48:00,1,186.01,17,4,1,1,6,One-Time
15568,2011-12-07 11:27:00,3,758.29,1,4,2,2,8,Other
15569,2011-08-28 10:15:00,10,3583.45,102,2,4,4,10,High-Value
15570,2011-12-02 14:47:00,25,8736.49,6,4,4,4,12,High-Value
15571,2011-11-28 10:02:00,14,3892.35,10,4,4,4,12,High-Value
15572,2011-12-05 10:09:00,10,3965.2,3,4,4,4,12,High-Value
15573,2011-11-08 11:38:00,5,1180.47,30,3,3,3,9,High-Value
15574,2011-06-15 12:01:00,6,1101.44,176,2,3,3,8,Other
15575,2010-03-30 12:50:00,1,30.1,618,1,1,1,3,At-Risk
15576,2011-11-02 12:03:00,1,921.37,36,3,1,3,7,Other
15577,2011-07-11 17:03:00,5,396.03,150,2,3,2,7,Other
15578,2011-06-30 13:03:00,1,127.1,161,2,1,1,4,One-Time
15579,2011-10-02 12:45:00,5,1250.63,67,3,3,3,9,High-Value
15580,2010-11-28 11:00:00,8,1375.39,375,2,4,3,9,High-Value
15581,2011-07-06 14:04:00,34,4505.16,155,2,4,4,10,High-Value
15582,2011-11-15 09:55:00,3,682.91,23,4,2,2,8,Other
15583,2010-11-28 15:04:00,1,95.96,375,2,1,1,4,One-Time
15584,2011-11-16 10:55:00,6,1268.2,22,4,3,3,10,High-Value
15585,2011-06-16 08:38:00,1,455.3,175,2,1,2,5,Other
15586,2010-04-26 11:00:00,3,1139.1,591,1,2,3,6,At-Risk
15587,2011-10-20 13:37:00,7,1522.08,49,3,4,3,10,High-Value
15588,2010-01-31 12:19:00,1,579.6,676,1,1,2,4,At-Risk
15589,2011-03-29 09:54:00,3,478.53,254,2,2,2,6,Other
15590,2010-11-22 14:49:00,5,1496.6,381,1,3,3,7,At-Risk
15591,2010-05-06 09:23:00,3,217.9,581,1,2,1,4,At-Risk
15592,2011-10-24 08:59:00,1,388.58,45,3,1,2,6,Other
15593,2011-09-30 11:46:00,1,199.8,69,3,1,1,5,One-Time
15594,2011-11-24 08:53:00,5,1771.78,14,4,3,3,10,High-Value
15595,2010-08-09 12:27:00,1,357.6,486,1,1,2,4,At-Risk
15596,2011-08-31 10:55:00,9,2727.72,99,2,4,4,10,High-Value
15597,2011-11-04 13:26:00,2,563.37,34,3,2,2,7,Other
15598,2011-10-17 16:04:00,2,548.02,52,3,2,2,7,Other
15599,2011-11-13 11:44:00,3,1250.06,25,3,2,3,8,Other
15600,2010-10-07 14:30:00,4,1199.31,427,1,3,3,7,At-Risk
15601,2011-11-28 15:15:00,30,14191.74,10,4,4,4,12,High-Value
15602,2011-12-01 14:14:00,16,3137.96,7,4,4,4,12,High-Value
15603,2011-09-22 10:04:00,2,88.48,77,3,2,1,6,Other
15604,2011-10-18 14:47:00,1,216.39,51,3,1,1,5,One-Time
15605,2011-11-03 14:17:00,9,1741.95,35,3,4,3,10,High-Value
15606,2011-10-09 15:47:00,17,5230.99,60,3,4,4,11,High-Value
15607,2011-01-07 12:44:00,9,1708.97,335,2,4,3,9,High-Value
15608,2011-11-11 13:20:00,5,1785.98,27,3,3,3,9,High-Value
15609,2011-06-08 13:00:00,1,298.48,183,2,1,1,4,One-Time
15610,2011-10-19 10:36:00,1,112.46,50,3,1,1,5,One-Time
15611,2011-11-30 12:36:00,24,2976.28,8,4,4,4,12,High-Value
15612,2011-11-03 14:52:00,2,195.15,35,3,2,1,6,Other
15613,2010-04-08 12:51:00,1,433.72,609,1,1,2,4,At-Risk
15614,2010-09-28 10:46:00,4,3147.36,436,1,3,4,8,At-Risk
15615,2011-11-29 14:42:00,47,21373.97,9,4,4,4,12,High-Value
15616,2010-09-27 13:10:00,1,317.11,437,1,1,1,3,At-Risk
15617,2010-11-08 16:07:00,3,828.55,395,1,2,2,5,At-Risk
15618,2011-11-07 08:34:00,4,776.85,31,3,3,2,8,Loyal
15619,2011-11-29 08:14:00,1,336.4,9,4,1,1,6,One-Time
15620,2011-10-14 12:41:00,4,1942.36,55,3,3,3,9,High-Value
15621,2011-12-05 14:01:00,4,1293.03,3,4,3,3,10,High-Value
15622,2011-10-27 16:44:00,17,7852.61,42,3,4,4,11,High-Value
15623,2011-07-21 17:26:00,8,2437.05,140,2,4,4,10,High-Value
15624,2011-08-15 11:38:00,4,588.13,115,2,3,2,7,Other
15625,2011-08-28 10:21:00,9,3236.4,102,2,4,4,10,High-Value
15626,2011-09-26 10:03:00,3,1067.52,73,3,2,3,8,Other
15627,2010-09-08 14:14:00,2,566.9,456,1,2,2,5,At-Risk
15628,2011-12-05 10:24:00,17,5333.08,3,4,4,4,12,High-Value
15629,2010-09-15 13:46:00,4,2240.9,449,1,3,3,7,At-Risk
15630,2011-10-25 15:36:00,3,1481.4,44,3,2,3,8,Other
15631,2010-03-07 14:52:00,1,596.67,641,1,1,2,4,At-Risk
15632,2011-11-24 09:51:00,8,3285.31,14,4,4,4,12,High-Value
15633,2010-07-18 13:54:00,13,4335.96,508,1,4,4,9,High-Value
15634,2011-11-22 16:28:00,2,554.65,16,4,2,2,8,Other
15635,2010-11-09 08:58:00,1,100.35,394,1,1,1,3,At-Risk
15636,2011-09-11 11:17:00,4,1444.58,88,3,3,3,9,High-Value
15637,2011-10-18 08:28:00,5,797.59,51,3,3,2,8,Loyal
15638,2010-11-26 11:52:00,6,2265.2,377,2,3,4,9,High-Value
15639,2011-07-28 14:30:00,3,1065.08,133,2,2,3,7,Other
15640,2011-12-05 14:35:00,29,23459.51,3,4,4,4,12,High-Value
15641,2011-08-26 14:04:00,12,5345.55,104,2,4,4,10,High-Value
15642,2009-12-10 11:51:00,1,105.78,728,1,1,1,3,At-Risk
15643,2011-06-01 07:38:00,3,664.0,190,2,2,2,6,Other
15644,2011-06-26 14:54:00,4,803.54,165,2,3,2,7,Other
15645,2011-11-21 11:55:00,3,1054.75,17,4,2,3,9,High-Value
15646,2011-07-05 09:53:00,5,784.81,156,2,3,2,7,Other
15647,2010-10-20 15:09:00,1,169.0,414,1,1,1,3,At-Risk
15648,2011-05-19 15:53:00,2,639.5,203,2,2,2,6,Other
15649,2011-01-07 13:34:00,4,1660.35,335,2,3,3,8,Other
15650,2010-07-06 10:41:00,2,553.88,520,1,2,2,5,At-Risk
15651,2011-11-03 08:41:00,5,1259.06,35,3,3,3,9,High-Value
15652,2011-09-09 14:22:00,5,1405.94,90,3,3,3,9,High-Value
15653,2011-09-08 10:49:00,2,877.44,91,3,2,3,8,Other
15654,2011-11-30 13:08:00,2,922.53,8,4,2,3,9,High-Value
15655,2011-04-10 15:25:00,1,560.67,242,2,1,2,5,Other
15656,2011-10-25 14:56:00,4,748.5,44,3,3,2,8,Loyal
15657,2011-11-17 12:19:00,1,30.0,21,4,1,1,6,One-Time
15658,2011-06-02 15:22:00,8,2117.27,189,2,4,3,9,High-Value
15659,2011-10-27 09:23:00,3,532.49,42,3,2,2,7,Other
15660,2011-11-14 16:58:00,15,2603.69,24,4,4,4,12,High-Value
15661,2011-01-26 13:56:00,8,1215.95,316,2,4,3,9,High-Value
15662,2010-02-16 16:47:00,2,283.73,660,1,2,1,4,At-Risk
15663,2011-08-25 15:50:00,1,138.14,105,2,1,1,4,One-Time
15664,2011-10-20 10:57:00,4,1231.53,49,3,3,3,9,High-Value
15665,2011-06-24 14:57:00,5,3987.07,167,2,3,4,9,High-Value
15666,2010-08-24 16:14:00,2,632.94,471,1,2,2,5,At-Risk
15667,2011-10-31 10:56:00,1,301.32,38,3,1,1,5,One-Time
15668,2011-05-06 10:39:00,1,76.32,216,2,1,1,4,One-Time
15669,2011-10-30 16:03:00,4,684.34,39,3,3,2,8,Loyal
15670,2011-02-16 10:50:00,2,325.2,295,2,2,1,5,Other
15671,2011-11-21 12:43:00,7,2657.13,17,4,4,4,12,High-Value
15672,2009-12-14 16:52:00,1,45.3,724,1,1,1,3,At-Risk
15673,2011-09-12 16:12:00,9,6204.32,87,3,4,4,11,High-Value
15674,2011-09-27 15:17:00,12,6613.52,72,3,4,4,11,High-Value
15675,2011-09-19 13:48:00,4,542.04,80,3,3,2,8,Loyal
15676,2011-11-21 12:40:00,3,3435.76,17,4,2,4,10,High-Value
15677,2011-10-21 15:36:00,3,1305.63,48,3,2,3,8,Other
15678,2011-10-18 09:25:00,3,1825.94,51,3,2,3,8,Other
15679,2011-11-15 16:19:00,4,781.28,23,4,3,2,9,High-Value
15680,2011-11-30 13:46:00,10,4028.69,8,4,4,4,12,High-Value
15681,2011-11-14 16:30:00,14,2989.7,24,4,4,4,12,High-Value
15682,2010-04-19 15:30:00,2,318.24,598,1,2,1,4,At-Risk
15683,2011-08-14 12:56:00,2,524.54,116,2,2,2,6,Other
15684,2010-06-10 18:51:00,3,173.95,546,1,2,1,4,At-Risk
15685,2010-09-15 13:43:00,1,55.98,449,1,1,1,3,At-Risk
15686,2010-10-15 13:50:00,1,90.0,419,1,1,1,3,At-Risk
15687,2011-12-01 08:33:00,9,2993.1,7,4,4,4,12,High-Value
15688,2010-10-17 12:06:00,1,190.57,417,1,1,1,3,At-Risk
15689,2011-08-12 09:37:00,3,521.03,118,2,3,2,7,Other
15690,2011-12-05 15:59:00,2,239.76,3,4,2,1,7,Other
15691,2011-04-01 15:13:00,4,571.3,251,2,3,2,7,Other
15692,2011-11-11 14:12:00,1,191.04,27,3,1,1,5,One-Time
15693,2010-02-18 14:37:00,1,37.5,658,1,1,1,3,At-Risk
15694,2011-12-09 09:44:00,23,9963.48,-1,4,4,4,12,High-Value
15695,2011-03-18 08:32:00,4,1131.04,265,2,3,3,8,Other
15696,2011-11-06 14:02:00,13,3881.22,32,3,4,4,11,High-Value
15697,2010-01-19 09:10:00,1,246.75,688,1,1,1,3,At-Risk
15698,2010-03-25 17:38:00,1,46.2,623,1,1,1,3,At-Risk
15699,2011-11-22 08:26:00,1,309.65,16,4,1,1,6,One-Time
15700,2011-06-20 16:53:00,2,696.68,171,2,2,2,6,Other
15701,2011-12-07 14:39:00,4,1529.0,1,4,3,3,10,High-Value
15702,2010-08-20 14:50:00,1,112.57,475,1,1,1,3,At-Risk
15703,2011-03-20 10:51:00,1,211.5,263,2,1,1,4,One-Time
15704,2011-07-22 13:35:00,6,3734.66,139,2,3,4,9,High-Value
15705,2011-05-22 15:37:00,1,143.1,200,2,1,1,4,One-Time
15706,2011-10-07 10:09:00,4,1060.56,62,3,3,3,9,High-Value
15707,2011-11-04 14:35:00,4,916.98,34,3,3,3,9,High-Value
15708,2011-10-30 10:54:00,9,3887.15,39,3,4,4,11,High-Value
15709,2011-03-01 10:38:00,2,327.85,282,2,2,1,5,Other
15710,2010-10-18 17:05:00,1,898.87,416,1,1,3,5,At-Risk
15711,2010-06-01 12:14:00,2,420.25,555,1,2,2,5,At-Risk
15712,2011-11-30 14:09:00,12,3472.41,8,4,4,4,12,High-Value
15713,2011-07-19 13:34:00,4,839.64,142,2,3,2,7,Other
15714,2011-11-28 11:26:00,5,783.96,10,4,3,2,9,High-Value
15715,2010-06-02 09:56:00,5,658.02,554,1,3,2,6,At-Risk
15716,2011-07-17 11:59:00,11,2482.74,144,2,4,4,10,High-Value
15717,2011-04-19 13:21:00,5,607.0,233,2,3,2,7,Other
15718,2010-06-17 16:20:00,1,293.79,539,1,1,1,3,At-Risk
15719,2011-11-07 12:29:00,31,10194.32,31,3,4,4,11,High-Value
15720,2011-11-15 14:48:00,2,739.22,23,4,2,2,8,Other
15721,2011-11-28 12:14:00,1,471.4,10,4,1,2,7,Other
15722,2011-11-04 11:43:00,11,5234.0,34,3,4,4,11,High-Value
15723,2010-12-10 11:12:00,4,930.7,363,2,3,3,8,Other
15724,2011-05-22 14:40:00,3,310.85,200,2,3,1,6,Other
15725,2011-11-24 14:51:00,1,415.25,14,4,1,2,7,Other
15726,2010-11-14 16:12:00,1,321.91,389,1,1,1,3,At-Risk
15727,2011-11-23 12:36:00,15,9371.71,15,4,4,4,12,High-Value
15728,2010-11-25 10:39:00,2,544.6,378,2,2,2,6,Other
15729,2011-05-11 12:36:00,3,192.55,211,2,3,1,6,Other
15730,2011-10-05 12:31:00,5,1726.58,64,3,3,3,9,High-Value
15731,2010-06-04 10:10:00,1,125.3,552,1,1,1,3,At-Risk
15732,2011-05-11 14:24:00,10,1543.97,211,2,4,3,9,High-Value
15733,2011-03-02 09:05:00,1,162.3,281,2,1,1,4,One-Time
15734,2011-08-17 10:50:00,4,2263.3,113,2,3,4,9,High-Value
15735,2010-10-14 13:38:00,1,327.68,420,1,1,1,3,At-Risk
15736,2010-09-30 14:20:00,2,1767.12,434,1,2,3,6,At-Risk
15737,2011-11-25 11:21:00,8,1188.12,13,4,4,3,11,High-Value
15738,2011-11-21 08:26:00,41,13043.32,17,4,4,4,12,High-Value
15739,2011-10-04 13:42:00,1,449.12,65,3,1,2,6,Other
15740,2011-10-21 14:29:00,1,154.88,48,3,1,1,5,One-Time
15741,2010-09-07 16:21:00,2,208.62,457,1,2,1,4,At-Risk
15742,2010-03-30 15:25:00,1,156.87,618,1,1,1,3,At-Risk
15743,2011-11-23 17:19:00,4,775.96,15,4,3,2,9,High-Value
15744,2011-09-23 09:52:00,1,34.8,76,3,1,1,5,One-Time
15745,2011-11-20 13:45:00,4,1094.59,18,4,3,3,10,High-Value
15746,2011-07-28 15:21:00,1,196.88,133,2,1,1,4,One-Time
15747,2011-11-27 12:26:00,9,2499.81,11,4,4,4,12,High-Value
15748,2011-10-30 12:51:00,3,609.81,39,3,3,2,8,Loyal
15749,2011-04-18 13:20:00,3,44534.3,234,2,3,4,9,High-Value
15750,2011-12-07 12:34:00,18,6452.99,1,4,4,4,12,High-Value
15751,2010-09-05 12:44:00,11,1380.44,459,1,4,3,8,At-Risk
15752,2011-10-31 11:37:00,9,3924.91,38,3,4,4,11,High-Value
15753,2011-02-08 12:41:00,1,79.2,303,2,1,1,4,One-Time
15754,2011-10-19 14:40:00,9,3037.61,50,3,4,4,11,High-Value
15755,2011-11-29 14:57:00,17,5993.12,9,4,4,4,12,High-Value
15756,2011-10-09 13:30:00,4,528.01,60,3,3,2,8,Loyal
15757,2011-10-05 12:14:00,6,2940.36,64,3,3,4,10,High-Value
15758,2011-11-15 10:48:00,1,205.25,23,4,1,1,6,One-Time
15759,2011-05-05 15:13:00,7,830.93,217,2,4,2,8,Other
15761,2010-09-23 09:33:00,1,143.05,441,1,1,1,3,At-Risk
15762,2011-10-05 16:15:00,2,583.75,64,3,2,2,7,Other
15763,2011-11-08 09:44:00,2,1086.92,30,3,2,3,8,Other
15764,2011-09-12 17:58:00,8,4503.08,87,3,4,4,11,High-Value
15765,2010-02-11 10:25:00,1,370.63,665,1,1,2,4,At-Risk
15766,2011-10-06 17:03:00,3,831.06,63,3,3,2,8,Loyal
15768,2011-08-16 10:48:00,34,15308.89,114,2,4,4,10,High-Value
15769,2011-12-02 13:52:00,46,88612.52,6,4,4,4,12,High-Value
15770,2010-04-06 11:47:00,1,321.45,611,1,1,1,3,At-Risk
15771,2010-04-14 13:56:00,3,1006.54,603,1,3,3,7,At-Risk
15772,2010-10-17 13:33:00,1,280.88,417,1,1,1,3,At-Risk
15773,2011-12-04 12:48:00,2,774.52,4,4,2,2,8,Other
15774,2011-10-02 12:04:00,6,1287.09,67,3,3,3,9,High-Value
15775,2011-04-08 12:56:00,2,150.5,244,2,2,1,5,Other
15776,2011-07-29 13:46:00,1,241.62,132,2,1,1,4,One-Time
15777,2011-04-12 16:43:00,7,1762.61,240,2,4,3,9,High-Value
15778,2010-10-04 15:10:00,1,307.95,430,1,1,1,3,At-Risk
15779,2010-09-02 16:40:00,2,124.08,462,1,2,1,4,At-Risk
15780,2011-06-09 12:01:00,3,475.28,182,2,3,2,7,Other
15781,2011-11-14 14:57:00,3,345.46,24,4,3,2,9,High-Value
15782,2011-11-30 10:49:00,4,4014.1,8,4,3,4,11,High-Value
15783,2011-11-29 09:50:00,1,246.3,9,4,1,1,6,One-Time
15784,2010-08-29 10:38:00,2,848.33,466,1,2,2,5,At-Risk
15785,2011-11-07 11:33:00,16,5969.93,31,3,4,4,11,High-Value
15786,2011-10-24 14:13:00,5,8501.62,45,3,3,4,10,High-Value
15787,2011-11-13 14:55:00,3,933.26,25,3,3,3,9,High-Value
15788,2010-07-19 12:48:00,1,221.83,507,1,1,1,3,At-Risk
15789,2010-12-16 14:35:00,6,1962.01,357,2,3,3,8,Other
15790,2011-11-29 14:53:00,1,218.75,9,4,1,1,6,One-Time
15791,2011-10-27 10:14:00,5,3608.34,42,3,3,4,10,High-Value
15792,2010-11-05 08:21:00,2,933.84,398,1,2,3,6,At-Risk
15793,2011-11-25 09:31:00,8,2399.57,13,4,4,4,12,High-Value
15794,2009-12-03 13:04:00,2,777.0,735,1,2,2,5,At-Risk
15795,2011-07-13 10:43:00,8,1979.87,148,2,4,3,9,High-Value
15796,2011-12-08 19:55:00,17,5170.63,0,4,4,4,12,High-Value
15797,2011-08-18 17:04:00,5,2806.08,112,2,3,4,9,High-Value
15798,2010-08-04 09:13:00,3,1535.37,491,1,3,3,7,At-Risk
15799,2011-09-25 12:46:00,4,1421.34,74,3,3,3,9,High-Value
15800,2011-08-24 14:23:00,7,1227.07,106,2,4,3,9,High-Value
15801,2011-10-24 13:52:00,3,1063.95,45,3,3,3,9,High-Value
15803,2011-10-19 14:56:00,4,1929.66,50,3,3,3,9,High-Value
15804,2011-12-09 12:31:00,13,4206.39,-1,4,4,4,12,High-Value
15805,2011-11-16 16:32:00,30,10148.93,22,4,4,4,12,High-Value
15806,2011-10-24 14:35:00,3,784.58,45,3,3,2,8,Loyal
15807,2011-10-20 14:10:00,5,1817.52,49,3,3,3,9,High-Value
15808,2011-02-06 14:33:00,21,17180.25,305,2,4,4,10,High-Value
15809,2011-11-03 16:40:00,7,1274.44,35,3,4,3,10,High-Value
15810,2011-09-22 09:38:00,8,2999.04,77,3,4,4,11,High-Value
15811,2011-11-17 15:31:00,7,3392.55,21,4,4,4,12,High-Value
15812,2011-08-24 14:19:00,12,5201.47,106,2,4,4,10,High-Value
15813,2011-05-16 08:13:00,2,1303.91,206,2,2,3,7,Other
15814,2011-11-23 08:17:00,6,2634.44,15,4,3,4,11,High-Value
15815,2011-10-07 12:42:00,5,2100.6,62,3,3,3,9,High-Value
15816,2010-06-15 13:36:00,2,144.15,541,1,2,1,4,At-Risk
15817,2010-10-15 11:07:00,3,2766.4,419,1,3,4,8,At-Risk
15818,2010-04-30 12:58:00,1,340.5,587,1,1,2,4,At-Risk
15819,2011-10-21 14:50:00,10,3934.79,48,3,4,4,11,High-Value
15820,2011-01-24 12:00:00,1,206.98,318,2,1,1,4,One-Time
15821,2011-10-26 15:48:00,2,570.96,43,3,2,2,7,Other
15822,2011-12-06 14:50:00,6,1840.06,2,4,3,3,10,High-Value
15823,2009-12-10 18:03:00,2,3867.17,728,1,2,4,7,At-Risk
15824,2010-09-12 13:20:00,2,890.94,452,1,2,3,6,At-Risk
15825,2011-06-20 13:27:00,1,532.94,171,2,1,2,5,Other
15826,2011-10-14 16:05:00,4,2598.28,55,3,3,4,10,High-Value
15827,2011-09-27 15:35:00,28,3603.14,72,3,4,4,11,High-Value
15828,2010-11-29 16:41:00,1,1108.82,374,2,1,3,6,Other
15829,2011-09-01 16:45:00,2,636.14,98,2,2,2,6,Other
15830,2011-11-02 10:40:00,1,576.0,36,3,1,2,6,Other
15831,2011-10-12 13:14:00,3,794.64,57,3,3,2,8,Loyal
15832,2011-03-30 15:29:00,1,836.79,253,2,1,2,5,Other
15833,2009-12-02 11:59:00,1,80.4,736,1,1,1,3,At-Risk
15834,2011-09-30 14:41:00,7,3761.89,69,3,4,4,11,High-Value
15835,2011-10-26 15:47:00,4,954.09,43,3,3,3,9,High-Value
15836,2011-10-20 17:13:00,1,137.37,49,3,1,1,5,One-Time
15837,2011-10-06 09:01:00,2,777.01,63,3,2,2,7,Other
15838,2011-11-28 14:00:00,34,73205.5,10,4,4,4,12,High-Value
15839,2011-11-06 13:54:00,3,1048.49,32,3,3,3,9,High-Value
15840,2011-10-12 09:08:00,2,355.56,57,3,2,2,7,Other
15841,2011-09-28 12:15:00,9,2742.41,71,3,4,4,11,High-Value
15842,2010-11-11 14:08:00,2,548.8,392,1,2,2,5,At-Risk
15843,2011-02-09 10:19:00,1,118.95,302,2,1,1,4,One-Time
15844,2011-10-24 15:19:00,1,130.74,45,3,1,1,5,One-Time
15845,2011-11-22 09:42:00,11,4426.28,16,4,4,4,12,High-Value
15846,2010-11-19 14:40:00,1,107.01,384,1,1,1,3,At-Risk
15847,2011-11-01 14:41:00,5,822.57,37,3,3,2,8,Loyal
15848,2010-03-28 10:54:00,1,137.99,620,1,1,1,3,At-Risk
15850,2011-11-20 14:14:00,6,1006.75,18,4,3,3,10,High-Value
15851,2010-07-01 12:34:00,1,109.73,525,1,1,1,3,At-Risk
15852,2011-06-06 11:22:00,3,257.26,185,2,3,1,6,Other
15853,2011-10-19 10:38:00,1,110.8,50,3,1,1,5,One-Time
15854,2011-12-05 13:39:00,21,5578.28,3,4,4,4,12,High-Value
15855,2011-07-26 10:20:00,6,1052.72,135,2,3,3,8,Other
15856,2011-12-05 17:09:00,52,32274.69,3,4,4,4,12,High-Value
15857,2011-11-21 12:18:00,2,570.48,17,4,2,2,8,Other
15858,2011-11-24 12:48:00,13,3552.41,14,4,4,4,12,High-Value
15859,2010-10-03 12:52:00,1,438.46,431,1,1,2,4,At-Risk
15860,2011-10-30 11:25:00,17,2358.8,39,3,4,4,11,High-Value
15861,2011-11-27 15:59:00,12,4360.9,11,4,4,4,12,High-Value
15862,2011-12-01 13:28:00,13,2507.14,7,4,4,4,12,High-Value
15863,2011-11-14 12:49:00,5,355.1,24,4,3,2,9,High-Value
15864,2011-11-17 13:32:00,7,2180.76,21,4,4,3,11,High-Value
15865,2011-10-30 12:43:00,5,2241.42,39,3,3,4,10,High-Value
15866,2011-08-30 14:09:00,1,211.89,100,2,1,1,4,One-Time
15867,2011-12-04 13:32:00,31,8869.87,4,4,4,4,12,High-Value
15868,2010-05-05 14:11:00,1,94.53,582,1,1,1,3,At-Risk
15869,2011-03-07 17:23:00,3,321.11,276,2,3,1,6,Other
15870,2011-11-07 10:58:00,4,857.46,31,3,3,3,9,High-Value
15871,2010-09-28 14:16:00,1,33.1,436,1,1,1,3,At-Risk
15872,2011-11-25 11:55:00,4,729.25,13,4,3,2,9,High-Value
15873,2010-07-28 12:41:00,4,313.92,498,1,3,1,5,At-Risk
15874,2011-10-07 12:31:00,21,11284.76,62,3,4,4,11,High-Value
15875,2010-03-03 16:51:00,1,108.52,645,1,1,1,3,At-Risk
15876,2010-10-26 18:58:00,2,1449.14,408,1,2,3,6,At-Risk
15877,2011-12-08 11:53:00,2,490.33,0,4,2,2,8,Other
15878,2010-05-27 12:17:00,2,330.77,560,1,2,1,4,At-Risk
15879,2010-10-31 16:21:00,4,1137.8,403,1,3,3,7,At-Risk
15880,2010-12-05 13:00:00,1,329.03,368,2,1,1,4,One-Time
15881,2011-01-31 16:59:00,5,501.39,311,2,3,2,7,Other
15882,2011-05-25 11:35:00,8,1122.38,197,2,4,3,9,High-Value
15883,2011-12-07 17:05:00,2,396.48,1,4,2,2,8,Other
15884,2010-10-03 15:55:00,2,244.6,431,1,2,1,4,At-Risk
15885,2011-09-07 14:56:00,13,1921.82,92,3,4,3,10,High-Value
15886,2011-10-10 14:25:00,4,1052.87,59,3,3,3,9,High-Value
15887,2010-10-29 08:36:00,3,1027.15,405,1,3,3,7,At-Risk
15888,2011-09-20 12:30:00,3,423.49,79,3,3,2,8,Loyal
15889,2011-07-06 11:10:00,8,1407.05,155,2,4,3,9,High-Value
15890,2010-11-10 12:46:00,5,535.65,393,1,3,2,6,At-Risk
15891,2011-04-27 12:35:00,1,509.13,225,2,1,2,5,Other
15892,2010-02-08 16:23:00,1,128.2,668,1,1,1,3,At-Risk
15893,2010-08-15 11:12:00,1,305.28,480,1,1,1,3,At-Risk
15894,2011-03-31 13:50:00,2,257.6,252,2,2,1,5,Other
15895,2011-07-13 10:27:00,1,179.17,148,2,1,1,4,One-Time
15897,2011-05-29 13:50:00,2,208.59,193,2,2,1,5,Other
15898,2011-12-08 15:23:00,25,4992.7,0,4,4,4,12,High-Value
15899,2010-12-06 10:36:00,1,56.25,367,2,1,1,4,One-Time
15900,2011-11-16 12:19:00,4,886.57,22,4,3,3,10,High-Value
15901,2011-11-23 12:43:00,6,667.89,15,4,3,2,9,High-Value
15902,2010-11-24 16:57:00,1,145.01,379,1,1,1,3,At-Risk
15903,2011-11-30 08:08:00,12,8939.84,8,4,4,4,12,High-Value
15904,2011-12-01 14:50:00,1,164.68,7,4,1,1,6,One-Time
15905,2010-06-14 16:00:00,1,114.69,542,1,1,1,3,At-Risk
15906,2011-11-20 12:24:00,10,2530.19,18,4,4,4,12,High-Value
15907,2011-12-06 12:21:00,3,881.87,2,4,3,3,10,High-Value
15908,2010-08-06 11:56:00,2,758.62,489,1,2,2,5,At-Risk
15909,2011-06-19 10:38:00,1,191.94,172,2,1,1,4,One-Time
15910,2011-12-09 10:51:00,15,2661.17,-1,4,4,4,12,High-Value
15911,2010-03-26 12:06:00,8,1683.79,622,1,4,3,8,At-Risk
15912,2011-06-14 14:29:00,9,1074.7,177,2,4,3,9,High-Value
15913,2010-06-23 16:31:00,1,6.3,533,1,1,1,3,At-Risk
15914,2010-11-26 16:10:00,2,205.99,377,2,2,1,5,Other
15915,2010-11-03 11:13:00,1,364.24,400,1,1,2,4,At-Risk
15916,2011-11-23 13:46:00,13,3145.24,15,4,4,4,12,High-Value
15917,2011-04-06 10:40:00,5,530.17,246,2,3,2,7,Other
15918,2011-06-02 11:42:00,3,582.88,189,2,3,2,7,Other
15919,2011-11-20 11:28:00,2,525.69,18,4,2,2,8,Other
15920,2011-07-08 15:25:00,8,565.19,153,2,4,2,8,Other
15921,2011-06-20 11:03:00,4,765.61,171,2,3,2,7,Other
15922,2010-12-01 13:51:00,1,369.5,372,2,1,2,5,Other
15923,2010-12-02 12:16:00,1,127.08,371,2,1,1,4,One-Time
15924,2009-12-08 15:00:00,1,102.82,730,1,1,1,3,At-Risk
15925,2011-05-29 15:35:00,1,207.15,193,2,1,1,4,One-Time
15926,2010-06-15 15:23:00,1,134.44,541,1,1,1,3,At-Risk
15927,2010-03-02 13:25:00,1,106.54,646,1,1,1,3,At-Risk
15928,2010-02-21 15:16:00,1,293.53,655,1,1,1,3,At-Risk
15929,2010-03-05 14:56:00,1,594.0,643,1,1,2,4,At-Risk
15930,2011-10-03 14:52:00,1,426.63,66,3,1,2,6,Other
15931,2010-10-07 16:46:00,1,239.9,427,1,1,1,3,At-Risk
15932,2011-12-05 17:13:00,8,2495.87,3,4,4,4,12,High-Value
15933,2011-11-18 13:14:00,3,1107.46,20,4,3,3,10,High-Value
15934,2010-10-18 10:13:00,2,2190.66,416,1,2,3,6,At-Risk
15935,2011-04-14 13:27:00,1,108.04,238,2,1,1,4,One-Time
15936,2010-11-25 16:39:00,2,282.79,378,2,2,1,5,Other
15937,2011-10-06 15:48:00,1,145.35,63,3,1,1,5,One-Time
15938,2011-08-19 12:56:00,9,734.81,111,2,4,2,8,Other
15939,2011-09-11 11:30:00,15,9004.84,88,3,4,4,11,High-Value
15940,2011-02-01 16:18:00,1,35.8,310,2,1,1,4,One-Time
15941,2010-03-12 14:45:00,1,405.0,636,1,1,2,4,At-Risk
15942,2011-07-29 09:01:00,1,337.44,132,2,1,1,4,One-Time
15943,2010-02-28 12:49:00,2,271.29,648,1,2,1,4,At-Risk
15944,2011-03-08 10:33:00,4,2164.24,275,2,3,3,8,Other
15945,2010-12-09 13:14:00,4,646.27,364,2,3,2,7,Other
15946,2010-07-25 12:18:00,3,2304.18,501,1,3,4,8,At-Risk
15947,2011-09-18 10:46:00,1,1708.24,81,3,1,3,7,Other
15948,2011-12-01 15:32:00,3,1509.09,7,4,3,3,10,High-Value
15949,2011-11-23 09:09:00,2,364.72,15,4,2,2,8,Other
15950,2011-11-08 11:09:00,10,7120.91,30,3,4,4,11,High-Value
15951,2011-12-01 08:34:00,3,1013.17,7,4,3,3,10,High-Value
15952,2011-11-06 11:18:00,4,781.91,32,3,3,2,8,Loyal
15953,2011-11-24 15:32:00,18,3440.34,14,4,4,4,12,High-Value
15954,2010-04-29 13:35:00,1,187.8,588,1,1,1,3,At-Risk
15955,2011-11-15 14:15:00,22,8085.98,23,4,4,4,12,High-Value
15956,2010-06-06 13:06:00,2,617.6,550,1,2,2,5,At-Risk
15957,2011-11-08 12:14:00,3,921.25,30,3,3,3,9,High-Value
15958,2011-09-26 13:41:00,4,462.12,73,3,3,2,8,Loyal
15959,2010-01-26 16:38:00,3,542.89,681,1,3,2,6,At-Risk
15960,2010-11-30 15:57:00,4,410.95,373,2,3,2,7,Other
15961,2010-11-25 15:59:00,1,451.29,378,2,1,2,5,Other
15962,2010-09-16 13:48:00,1,289.48,448,1,1,1,3,At-Risk
15963,2011-11-20 11:33:00,2,470.76,18,4,2,2,8,Other
15964,2010-02-14 15:30:00,1,269.21,662,1,1,1,3,At-Risk
15965,2011-11-22 16:44:00,13,2771.94,16,4,4,4,12,High-Value
15966,2010-09-15 10:44:00,1,426.53,449,1,1,2,4,At-Risk
15967,2011-11-16 15:41:00,12,2966.0,22,4,4,4,12,High-Value
15968,2010-11-16 13:04:00,1,401.8,387,1,1,2,4,At-Risk
15969,2011-12-07 11:06:00,5,1127.05,1,4,3,3,10,High-Value
15970,2011-02-09 12:08:00,2,1017.32,302,2,2,3,7,Other
15971,2011-11-22 12:50:00,18,5897.88,16,4,4,4,12,High-Value
15972,2010-09-09 13:20:00,5,1769.33,455,1,3,3,7,At-Risk
15973,2010-12-08 11:42:00,2,665.62,365,2,2,2,6,Other
15974,2011-10-31 13:13:00,7,3442.15,38,3,4,4,11,High-Value
15975,2011-09-16 13:33:00,1,371.01,83,3,1,2,6,Other
15976,2011-06-27 13:00:00,6,1680.31,164,2,3,3,8,Other
15977,2011-11-22 13:29:00,2,1054.73,16,4,2,3,9,High-Value
15978,2011-09-23 15:21:00,3,3279.42,76,3,3,4,10,High-Value
15979,2010-04-16 11:35:00,1,329.22,601,1,1,1,3,At-Risk
15980,2011-09-12 09:41:00,7,6543.68,87,3,4,4,11,High-Value
15981,2011-11-15 08:00:00,21,9362.77,23,4,4,4,12,High-Value
15982,2010-04-13 15:47:00,1,324.51,604,1,1,1,3,At-Risk
15983,2011-11-17 17:34:00,8,3110.37,21,4,4,4,12,High-Value
15984,2011-12-07 12:16:00,30,8393.02,1,4,4,4,12,High-Value
15985,2011-08-08 16:31:00,7,2715.28,122,2,4,4,10,High-Value
15986,2011-11-09 15:17:00,2,354.42,29,3,2,2,7,Other
15987,2011-11-27 15:38:00,8,1535.99,11,4,4,3,11,High-Value
15988,2011-11-20 13:23:00,3,736.39,18,4,3,2,9,High-Value
15989,2010-11-29 12:03:00,2,368.31,374,2,2,2,6,Other
15990,2011-10-26 15:58:00,7,1997.75,43,3,4,3,10,High-Value
15991,2010-06-23 15:50:00,1,150.55,533,1,1,1,3,At-Risk
15992,2011-12-06 11:00:00,3,896.6,2,4,3,3,10,High-Value
15993,2011-12-01 10:45:00,7,2768.97,7,4,4,4,12,High-Value
15994,2011-10-16 12:28:00,3,1175.68,53,3,3,3,9,High-Value
15995,2010-10-21 13:57:00,1,694.54,413,1,1,2,4,At-Risk
15996,2011-09-12 15:14:00,7,1386.4,87,3,4,3,10,High-Value
15998,2011-11-03 12:45:00,16,8274.14,35,3,4,4,11,High-Value
15999,2009-12-04 12:31:00,1,20.4,734,1,1,1,3,At-Risk
16000,2011-12-07 12:17:00,3,12393.7,1,4,3,4,11,High-Value
16001,2010-11-23 17:10:00,1,583.39,380,1,1,2,4,At-Risk
16002,2010-03-24 13:08:00,1,169.21,624,1,1,1,3,At-Risk
16003,2011-11-10 09:57:00,10,5613.83,28,3,4,4,11,High-Value
16004,2010-08-22 11:48:00,5,2146.39,473,1,3,3,7,At-Risk
16005,2011-11-27 13:47:00,10,2365.07,11,4,4,4,12,High-Value
16006,2011-05-12 13:12:00,2,332.82,210,2,2,1,5,Other
16007,2011-10-23 11:05:00,7,3053.06,46,3,4,4,11,High-Value
16008,2011-11-16 10:32:00,15,5339.13,22,4,4,4,12,High-Value
16009,2011-11-17 16:51:00,4,972.11,21,4,3,3,10,High-Value
16010,2011-04-08 10:14:00,11,1694.86,244,2,4,3,9,High-Value
16011,2011-12-01 16:31:00,29,5599.31,7,4,4,4,12,High-Value
16012,2011-11-04 13:25:00,5,2978.59,34,3,3,4,10,High-Value
16013,2011-12-06 10:36:00,84,56078.44,2,4,4,4,12,High-Value
16014,2011-11-02 12:04:00,5,1100.28,36,3,3,3,9,High-Value
16015,2011-12-06 10:58:00,3,704.26,2,4,3,2,9,High-Value
16016,2011-12-06 14:35:00,11,2083.4,2,4,4,3,11,High-Value
16017,2011-10-23 12:56:00,5,1545.58,46,3,3,3,9,High-Value
16018,2011-10-31 14:13:00,4,698.13,38,3,3,2,8,Loyal
16019,2011-10-24 11:51:00,27,17329.16,45,3,4,4,11,High-Value
16020,2011-11-23 11:18:00,3,851.01,15,4,3,2,9,High-Value
16021,2010-11-09 14:48:00,2,487.03,394,1,2,2,5,At-Risk
16022,2011-03-24 13:16:00,1,602.63,259,2,1,2,5,Other
16023,2011-10-24 16:34:00,3,719.81,45,3,3,2,8,Loyal
16024,2011-11-27 13:26:00,3,478.71,11,4,3,2,9,High-Value
16025,2011-11-10 11:45:00,1,439.66,28,3,1,2,6,Other
16026,2011-10-27 13:53:00,1,236.09,42,3,1,1,5,One-Time
16027,2011-09-09 10:47:00,15,2048.36,90,3,4,3,10,High-Value
16028,2010-04-23 11:45:00,1,82.2,594,1,1,1,3,At-Risk
16029,2011-11-01 10:27:00,106,109620.87,37,3,4,4,11,High-Value
16030,2011-02-03 11:28:00,1,331.24,308,2,1,1,4,One-Time
16031,2011-09-08 13:07:00,2,547.9,91,3,2,2,7,Other
16032,2010-09-09 18:00:00,6,1965.72,455,1,3,3,7,At-Risk
16033,2011-12-04 12:44:00,27,10608.81,4,4,4,4,12,High-Value
16034,2011-05-27 16:17:00,6,911.32,195,2,3,3,8,Other
16035,2010-05-28 15:09:00,1,217.73,559,1,1,1,3,At-Risk
16036,2011-09-13 14:53:00,4,2556.84,86,3,3,4,10,High-Value
16037,2011-03-15 09:13:00,5,1509.34,268,2,3,3,8,Other
16038,2011-12-02 12:40:00,3,471.78,6,4,3,2,9,High-Value
16039,2010-10-12 10:44:00,2,456.4,422,1,2,2,5,At-Risk
16040,2011-10-05 13:47:00,7,2416.9,64,3,4,4,11,High-Value
16041,2011-11-09 12:25:00,3,3166.4,29,3,3,4,10,High-Value
16042,2011-11-17 17:50:00,8,2245.32,21,4,4,4,12,High-Value
16043,2011-11-02 12:50:00,8,1856.59,36,3,4,3,10,High-Value
16044,2010-09-30 18:12:00,1,340.84,434,1,1,2,4,At-Risk
16045,2011-08-12 12:41:00,8,3434.93,118,2,4,4,10,High-Value
16046,2010-05-26 13:18:00,1,235.78,561,1,1,1,3,At-Risk
16048,2010-12-01 15:28:00,4,818.79,372,2,3,2,7,Other
16049,2011-10-30 13:19:00,6,1852.15,39,3,3,3,9,High-Value
16050,2011-06-19 11:44:00,3,300.7,172,2,3,1,6,Other
16051,2010-01-27 09:38:00,1,188.44,680,1,1,1,3,At-Risk
16052,2011-10-16 15:13:00,1,362.06,53,3,1,2,6,Other
16053,2011-11-07 11:21:00,6,3634.84,31,3,3,4,10,High-Value
16054,2011-07-17 13:08:00,4,2111.88,144,2,3,3,8,Other
16055,2011-05-03 09:26:00,1,134.8,219,2,1,1,4,One-Time
16056,2011-10-25 15:19:00,1,650.75,44,3,1,2,6,Other
16057,2011-11-23 15:23:00,10,3854.85,15,4,4,4,12,High-Value
16058,2010-10-29 16:48:00,1,62.7,405,1,1,1,3,At-Risk
16059,2011-10-05 09:56:00,12,3053.57,64,3,4,4,11,High-Value
16060,2010-11-04 12:10:00,3,541.95,399,1,3,2,6,At-Risk
16061,2010-10-04 15:29:00,1,89.65,430,1,1,1,3,At-Risk
16062,2011-11-30 12:15:00,8,2863.45,8,4,4,4,12,High-Value
16063,2011-03-24 14:55:00,1,335.32,259,2,1,1,4,One-Time
16064,2009-12-14 16:11:00,1,109.31,724,1,1,1,3,At-Risk
16065,2010-12-09 13:03:00,8,1992.13,364,2,4,3,9,High-Value
16066,2011-11-23 11:54:00,5,1521.04,15,4,3,3,10,High-Value
16067,2010-05-26 12:33:00,3,3269.11,561,1,3,4,8,At-Risk
16068,2010-04-25 11:52:00,1,115.73,592,1,1,1,3,At-Risk
16069,2010-10-18 10:32:00,1,457.7,416,1,1,2,4,At-Risk
16070,2011-11-17 15:50:00,2,852.15,21,4,2,2,8,Other
16071,2011-10-26 11:14:00,4,1076.8,43,3,3,3,9,High-Value
16072,2011-02-24 14:32:00,4,4180.09,287,2,3,4,9,High-Value
16073,2011-02-15 15:41:00,1,122.4,296,2,1,1,4,One-Time
16074,2010-11-14 13:19:00,1,252.5,389,1,1,1,3,At-Risk
16075,2010-07-25 11:31:00,2,736.93,501,1,2,2,5,At-Risk
16076,2011-12-06 14:59:00,10,2234.73,2,4,4,3,11,High-Value
16077,2010-03-24 10:42:00,1,2300.4,624,1,1,4,6,At-Risk
16078,2011-03-01 09:47:00,2,362.99,282,2,2,2,6,Other
16079,2011-11-23 12:48:00,3,1352.0,15,4,3,3,10,High-Value
16080,2011-09-19 10:42:00,4,602.56,80,3,3,2,8,Loyal
16081,2011-10-14 13:06:00,8,4278.96,55,3,4,4,11,High-Value
16082,2010-02-07 15:16:00,1,106.75,669,1,1,1,3,At-Risk
16083,2011-08-31 10:47:00,4,2351.42,99,2,3,4,9,High-Value
16084,2011-02-13 16:05:00,1,436.18,298,2,1,2,5,Other
16085,2011-11-16 13:24:00,12,2324.71,22,4,4,4,12,High-Value
16086,2011-10-11 13:09:00,10,2687.73,58,3,4,4,11,High-Value
16087,2010-11-15 16:44:00,5,1739.92,388,1,3,3,7,At-Risk
16088,2010-05-13 10:16:00,2,1437.43,574,1,2,3,6,At-Risk
16089,2010-11-18 13:51:00,2,263.49,385,1,2,1,4,At-Risk
16090,2010-03-25 13:05:00,1,180.56,623,1,1,1,3,At-Risk
16091,2011-07-08 08:45:00,2,315.06,153,2,2,1,5,Other
16092,2011-08-17 10:46:00,6,1587.94,113,2,3,3,8,Other
16093,2011-08-25 11:09:00,1,17.0,105,2,1,1,4,One-Time
16094,2011-11-28 12:45:00,11,3695.56,10,4,4,4,12,High-Value
16095,2010-09-09 16:54:00,1,447.05,455,1,1,2,4,At-Risk
16096,2011-03-20 13:38:00,4,1584.97,263,2,3,3,8,Other
16097,2011-04-13 13:47:00,1,185.05,239,2,1,1,4,One-Time
16098,2011-09-13 09:59:00,14,4010.7,86,3,4,4,11,High-Value
16099,2011-10-20 13:13:00,7,1573.2,49,3,4,3,10,High-Value
16100,2010-09-03 11:39:00,1,582.64,461,1,1,2,4,At-Risk
16101,2011-09-30 10:18:00,4,3229.16,69,3,3,4,10,High-Value
16102,2011-10-28 13:19:00,3,1842.14,41,3,3,3,9,High-Value
16103,2011-12-02 14:16:00,22,6191.71,6,4,4,4,12,High-Value
16104,2011-10-09 10:23:00,9,2774.46,60,3,4,4,11,High-Value
16105,2011-04-05 10:13:00,5,2386.19,247,2,3,4,9,High-Value
16106,2011-10-05 10:37:00,1,108.38,64,3,1,1,5,One-Time
16107,2011-11-22 09:40:00,7,3204.16,16,4,4,4,12,High-Value
16108,2011-09-16 11:48:00,4,2235.92,83,3,3,3,9,High-Value
16109,2011-05-05 09:17:00,3,939.48,217,2,3,3,8,Other
16110,2011-10-25 14:35:00,4,1781.59,44,3,3,3,9,High-Value
16111,2010-10-07 19:51:00,1,549.33,427,1,1,2,4,At-Risk
16112,2011-07-19 14:28:00,4,195.74,142,2,3,1,6,Other
16113,2011-06-09 16:16:00,1,161.38,182,2,1,1,4,One-Time
16114,2011-06-22 10:13:00,1,135.75,169,2,1,1,4,One-Time
16115,2011-11-30 11:32:00,12,2553.8,8,4,4,4,12,High-Value
16116,2011-05-12 12:01:00,1,612.78,210,2,1,2,5,Other
16117,2011-06-03 11:42:00,3,654.4,188,2,3,2,7,Other
16118,2010-02-25 09:40:00,1,4376.25,651,1,1,4,6,At-Risk
16119,2011-12-01 15:11:00,8,1720.81,7,4,4,3,11,High-Value
16120,2011-10-11 14:22:00,6,2967.51,58,3,3,4,10,High-Value
16121,2011-10-13 12:59:00,5,1450.04,56,3,3,3,9,High-Value
16122,2011-09-27 15:34:00,6,895.62,72,3,3,3,9,High-Value
16123,2011-10-19 09:18:00,1,307.78,50,3,1,1,5,One-Time
16124,2011-01-26 14:45:00,4,1772.49,316,2,3,3,8,Other
16125,2010-12-07 15:48:00,14,4292.35,366,2,4,4,10,High-Value
16126,2011-11-10 16:03:00,15,14644.6,28,3,4,4,11,High-Value
16127,2011-10-31 13:58:00,2,801.31,38,3,2,2,7,Other
16128,2011-11-22 11:14:00,11,3801.05,16,4,4,4,12,High-Value
16129,2010-10-28 14:29:00,3,1396.05,406,1,3,3,7,At-Risk
16130,2010-10-13 15:14:00,4,987.48,421,1,3,3,7,At-Risk
16131,2011-10-19 11:53:00,12,9957.42,50,3,4,4,11,High-Value
16132,2010-06-13 13:49:00,2,664.2,543,1,2,2,5,At-Risk
16133,2011-12-06 11:24:00,56,22992.26,2,4,4,4,12,High-Value
16134,2011-11-18 10:05:00,5,2145.34,20,4,3,3,10,High-Value
16135,2011-03-22 12:30:00,2,819.45,261,2,2,2,6,Other
16136,2011-10-11 09:10:00,4,946.8,58,3,3,3,9,High-Value
16137,2010-01-28 15:04:00,1,422.7,679,1,1,2,4,At-Risk
16138,2010-11-26 12:13:00,3,910.35,377,2,3,3,8,Other
16139,2011-11-21 08:37:00,5,1111.15,17,4,3,3,10,High-Value
16140,2011-10-05 12:15:00,3,1433.46,64,3,3,3,9,High-Value
16141,2011-09-12 13:11:00,2,955.94,87,3,2,3,8,Other
16142,2011-04-04 10:16:00,1,535.34,248,2,1,2,5,Other
16143,2011-12-06 14:13:00,12,4555.08,2,4,4,4,12,High-Value
16144,2011-04-07 10:09:00,1,175.2,245,2,1,1,4,One-Time
16145,2011-12-01 10:33:00,19,6805.44,7,4,4,4,12,High-Value
16146,2011-07-05 14:20:00,4,946.38,156,2,3,3,8,Other
16147,2011-07-29 09:57:00,5,2398.91,132,2,3,4,9,High-Value
16148,2011-02-16 14:01:00,2,386.62,295,2,2,2,6,Other
16149,2011-12-05 11:29:00,3,422.22,3,4,3,2,9,High-Value
16150,2011-10-28 12:39:00,10,4002.17,41,3,4,4,11,High-Value
16152,2011-03-16 09:47:00,1,1829.04,267,2,1,3,6,Other
16153,2011-10-21 10:50:00,11,5133.49,48,3,4,4,11,High-Value
16155,2010-11-23 12:03:00,5,796.9,380,1,3,2,6,At-Risk
16156,2011-12-01 12:42:00,20,6188.18,7,4,4,4,12,High-Value
16157,2011-11-24 11:41:00,3,656.69,14,4,3,2,9,High-Value
16158,2010-07-05 13:55:00,9,628.32,521,1,4,2,7,At-Risk
16159,2011-03-03 12:27:00,4,1232.79,280,2,3,3,8,Other
16160,2011-10-05 14:19:00,2,1025.44,64,3,2,3,8,Other
16161,2011-12-08 12:10:00,43,12580.06,0,4,4,4,12,High-Value
16162,2011-04-01 15:03:00,1,37.4,251,2,1,1,4,One-Time
16163,2011-04-21 15:15:00,6,2407.98,231,2,3,4,9,High-Value
16164,2011-11-22 15:04:00,3,822.48,16,4,3,2,9,High-Value
16165,2010-07-22 14:17:00,1,79.9,504,1,1,1,3,At-Risk
16166,2010-10-07 15:44:00,2,435.83,427,1,2,2,5,At-Risk
16167,2010-10-21 15:33:00,5,1386.12,413,1,3,3,7,At-Risk
16168,2011-11-29 12:45:00,66,10360.67,9,4,4,4,12,High-Value
16169,2011-12-01 15:28:00,4,1822.97,7,4,3,3,10,High-Value
16170,2011-10-20 08:21:00,20,6869.0,49,3,4,4,11,High-Value
16171,2011-10-11 14:51:00,1,73.2,58,3,1,1,5,One-Time
16172,2011-09-05 13:22:00,8,1884.55,94,3,4,3,10,High-Value
16173,2011-11-24 10:53:00,6,1418.32,14,4,3,3,10,High-Value
16174,2011-08-05 13:26:00,7,2246.75,125,2,4,4,10,High-Value
16175,2011-09-06 14:32:00,7,1836.44,93,3,4,3,10,High-Value
16176,2010-10-14 13:54:00,4,2052.69,420,1,3,3,7,At-Risk
16177,2011-10-20 12:57:00,8,2247.31,49,3,4,4,11,High-Value
16178,2011-07-24 16:05:00,2,612.6,137,2,2,2,6,Other
16179,2011-10-10 09:41:00,1,215.83,59,3,1,1,5,One-Time
16180,2011-08-31 16:28:00,13,16249.87,99,2,4,4,10,High-Value
16181,2011-09-27 13:38:00,1,305.54,72,3,1,1,5,One-Time
16182,2011-09-28 13:23:00,9,9971.65,71,3,4,4,11,High-Value
16183,2011-10-03 14:59:00,4,1077.81,66,3,3,3,9,High-Value
16184,2011-10-06 17:43:00,6,1158.79,63,3,3,3,9,High-Value
16185,2011-11-23 09:41:00,3,644.72,15,4,3,2,9,High-Value
16186,2011-11-17 12:43:00,26,8718.43,21,4,4,4,12,High-Value
16187,2011-11-08 09:50:00,15,6911.44,30,3,4,4,11,High-Value
16188,2011-10-26 12:19:00,5,1087.66,43,3,3,3,9,High-Value
16189,2011-11-24 11:47:00,2,215.48,14,4,2,1,7,Other
16190,2011-10-30 15:59:00,8,2723.55,39,3,4,4,11,High-Value
16191,2011-12-07 11:26:00,24,15677.82,1,4,4,4,12,High-Value
16192,2009-12-04 12:28:00,1,351.3,734,1,1,2,4,At-Risk
16193,2011-04-17 11:45:00,2,630.43,235,2,2,2,6,Other
16194,2010-11-29 13:28:00,1,308.6,374,2,1,1,4,One-Time
16195,2009-12-16 14:09:00,1,323.25,722,1,1,1,3,At-Risk
16196,2010-08-08 11:40:00,1,93.3,487,1,1,1,3,At-Risk
16197,2010-08-27 12:56:00,9,2016.71,468,1,4,3,8,At-Risk
16198,2011-09-25 14:58:00,2,1030.04,74,3,2,3,8,Other
16199,2010-11-12 12:55:00,7,942.75,391,1,4,3,8,At-Risk
16200,2011-12-05 14:40:00,12,5608.1,3,4,4,4,12,High-Value
16201,2011-12-06 16:02:00,5,2112.12,2,4,3,3,10,High-Value
16202,2010-12-14 10:43:00,9,2501.99,359,2,4,4,10,High-Value
16203,2011-10-12 12:31:00,6,943.84,57,3,3,3,9,High-Value
16204,2011-11-16 13:40:00,3,918.71,22,4,3,3,10,High-Value
16205,2011-11-09 09:32:00,7,1813.51,29,3,4,3,10,High-Value
16206,2011-10-16 10:41:00,13,2577.12,53,3,4,4,11,High-Value
16207,2011-11-14 13:51:00,1,394.38,24,4,1,2,7,Other
16208,2011-10-26 11:36:00,10,3440.45,43,3,4,4,11,High-Value
16209,2011-09-12 11:58:00,9,4146.78,87,3,4,4,11,High-Value
16210,2011-12-08 12:36:00,33,33730.97,0,4,4,4,12,High-Value
16211,2011-09-12 12:11:00,3,1090.59,87,3,3,3,9,High-Value
16212,2011-11-20 13:00:00,4,1293.71,18,4,3,3,10,High-Value
16213,2011-09-22 10:03:00,1,159.0,77,3,1,1,5,One-Time
16214,2011-06-22 11:30:00,4,2038.25,169,2,3,3,8,Other
16215,2011-09-20 10:18:00,1,242.35,79,3,1,1,5,One-Time
16216,2011-03-17 15:34:00,1,914.93,266,2,1,3,6,Other
16217,2011-04-18 13:31:00,2,304.25,234,2,2,1,5,Other
16218,2011-11-10 09:59:00,13,3968.67,28,3,4,4,11,High-Value
16219,2010-07-27 11:44:00,1,40.8,499,1,1,1,3,At-Risk
16221,2011-11-03 11:43:00,9,2018.47,35,3,4,3,10,High-Value
16222,2011-01-25 13:38:00,2,1272.05,317,2,2,3,7,Other
16223,2010-11-30 11:50:00,2,1087.05,373,2,2,3,7,Other
16224,2011-10-13 17:51:00,5,1616.54,56,3,3,3,9,High-Value
16225,2011-10-26 08:30:00,15,2859.31,43,3,4,4,11,High-Value
16226,2011-05-20 14:41:00,5,672.17,202,2,3,2,7,Other
16227,2011-04-28 13:33:00,3,1027.22,224,2,3,3,8,Other
16228,2010-11-19 14:20:00,3,885.71,384,1,3,3,7,At-Risk
16229,2011-09-13 17:16:00,6,2867.86,86,3,3,4,10,High-Value
16230,2011-06-03 10:06:00,2,542.03,188,2,2,2,6,Other
16231,2010-11-25 15:00:00,4,1074.47,378,2,3,3,8,Other
16232,2011-10-27 12:16:00,7,2712.97,42,3,4,4,11,High-Value
16233,2011-09-29 17:27:00,9,1818.31,70,3,4,3,10,High-Value
16234,2010-08-20 14:33:00,3,333.18,475,1,3,1,5,At-Risk
16235,2011-10-30 10:56:00,8,2043.71,39,3,4,3,10,High-Value
16236,2011-09-22 14:10:00,1,432.2,77,3,1,2,6,Other
16237,2010-09-28 17:02:00,1,136.65,436,1,1,1,3,At-Risk
16238,2010-10-13 12:36:00,1,63.66,421,1,1,1,3,At-Risk
16239,2011-10-14 08:29:00,6,1492.2,55,3,3,3,9,High-Value
16240,2011-11-15 14:30:00,2,3718.8,23,4,2,4,10,High-Value
16241,2011-11-30 11:08:00,16,3989.81,8,4,4,4,12,High-Value
16242,2011-12-01 15:12:00,14,7404.65,7,4,4,4,12,High-Value
16243,2011-11-06 12:32:00,2,409.1,32,3,2,2,7,Other
16244,2011-05-12 10:18:00,2,1522.75,210,2,2,3,7,Other
16245,2011-11-16 10:14:00,3,1413.66,22,4,3,3,10,High-Value
16246,2010-09-06 12:04:00,2,821.35,458,1,2,2,5,At-Risk
16247,2011-06-22 14:23:00,1,114.56,169,2,1,1,4,One-Time
16248,2011-10-09 11:32:00,1,152.94,60,3,1,1,5,One-Time
16249,2011-10-18 10:07:00,5,1800.07,51,3,3,3,9,High-Value
16250,2011-03-23 15:07:00,3,565.24,260,2,3,2,7,Other
16251,2010-07-15 14:55:00,1,128.31,511,1,1,1,3,At-Risk
16252,2010-11-22 11:57:00,1,295.09,381,1,1,1,3,At-Risk
16253,2011-10-04 09:09:00,7,7222.2,65,3,4,4,11,High-Value
16254,2010-11-26 13:22:00,3,967.44,377,2,3,3,8,Other
16255,2011-11-23 12:40:00,15,4530.0,15,4,4,4,12,High-Value
16256,2011-03-18 12:18:00,3,1579.37,265,2,3,3,8,Other
16257,2011-06-16 10:11:00,1,21.95,175,2,1,1,4,One-Time
16258,2011-10-25 13:30:00,15,11942.52,44,3,4,4,11,High-Value
16259,2010-10-25 14:27:00,3,340.94,409,1,3,2,6,At-Risk
16260,2011-10-20 09:40:00,1,1035.45,49,3,1,3,7,Other
16261,2011-11-22 17:23:00,6,1041.16,16,4,3,3,10,High-Value
16262,2010-11-26 13:22:00,1,755.15,377,2,1,2,5,Other
16263,2010-10-12 14:52:00,1,348.16,422,1,1,2,4,At-Risk
16264,2010-09-27 15:00:00,2,823.53,437,1,2,2,5,At-Risk
16265,2011-11-30 16:41:00,12,6685.17,8,4,4,4,12,High-Value
16266,2011-09-27 12:08:00,14,1757.95,72,3,4,3,10,High-Value
16267,2010-04-27 14:10:00,1,186.66,590,1,1,1,3,At-Risk
16268,2011-09-29 18:30:00,2,617.65,70,3,2,2,7,Other
16269,2010-09-28 11:50:00,1,717.57,436,1,1,2,4,At-Risk
16270,2010-12-21 14:26:00,1,1141.24,352,2,1,3,6,Other
16271,2011-11-24 12:12:00,8,3367.82,14,4,4,4,12,High-Value
16272,2011-08-15 10:53:00,1,411.7,115,2,1,2,5,Other
16273,2010-03-01 13:24:00,2,318.34,647,1,2,1,4,At-Risk
16274,2010-12-01 15:35:00,1,331.55,372,2,1,1,4,One-Time
16275,2011-05-27 12:41:00,3,2151.11,195,2,3,3,8,Other
16276,2011-06-16 09:34:00,3,2629.39,175,2,3,4,9,High-Value
16277,2009-12-06 11:27:00,1,188.69,732,1,1,1,3,At-Risk
16278,2011-08-31 17:12:00,3,1117.84,99,2,3,3,8,Other
16279,2011-11-18 15:00:00,9,5698.28,20,4,4,4,12,High-Value
16280,2009-12-14 15:49:00,1,238.05,724,1,1,1,3,At-Risk
16281,2011-09-28 14:57:00,3,3424.02,71,3,3,4,10,High-Value
16282,2011-01-04 11:42:00,3,1307.58,338,2,3,3,8,Other
16283,2011-12-04 12:08:00,8,4348.62,4,4,4,4,12,High-Value
16284,2011-11-08 16:12:00,3,1018.48,30,3,3,3,9,High-Value
16285,2010-03-03 16:03:00,1,176.9,645,1,1,1,3,At-Risk
16286,2010-08-19 14:48:00,2,328.95,476,1,2,1,4,At-Risk
16287,2011-06-23 09:08:00,5,1006.98,168,2,3,3,8,Other
16288,2010-08-26 14:45:00,1,129.85,469,1,1,1,3,At-Risk
16289,2010-09-03 14:02:00,1,136.31,461,1,1,1,3,At-Risk
16290,2010-09-01 11:52:00,4,1957.7,463,1,3,3,7,At-Risk
16292,2011-08-10 12:24:00,5,1253.76,120,2,3,3,8,Other
16293,2011-11-18 09:58:00,15,4279.2,20,4,4,4,12,High-Value
16294,2010-08-20 12:01:00,1,126.05,475,1,1,1,3,At-Risk
16295,2011-11-30 08:17:00,4,1328.55,8,4,3,3,10,High-Value
16296,2010-03-23 13:11:00,4,1313.67,625,1,3,3,7,At-Risk
16297,2011-03-16 08:29:00,1,301.9,267,2,1,1,4,One-Time
16298,2011-11-17 11:59:00,7,1085.7,21,4,4,3,11,High-Value
16299,2010-08-19 17:46:00,1,193.65,476,1,1,1,3,At-Risk
16300,2010-10-05 13:14:00,3,1367.32,429,1,3,3,7,At-Risk
16301,2009-12-03 10:20:00,1,107.33,735,1,1,1,3,At-Risk
16302,2011-08-05 09:44:00,1,233.22,125,2,1,1,4,One-Time
16303,2011-11-14 10:49:00,7,7928.27,24,4,4,4,12,High-Value
16304,2010-01-14 08:30:00,1,381.66,693,1,1,2,4,At-Risk
16305,2011-07-24 12:18:00,1,361.22,137,2,1,2,5,Other
16306,2011-05-10 12:12:00,7,1124.72,212,2,4,3,9,High-Value
16307,2010-10-06 14:31:00,3,1194.92,428,1,3,3,7,At-Risk
16308,2011-11-02 11:24:00,7,5120.0,36,3,4,4,11,High-Value
16309,2011-08-25 15:35:00,2,706.57,105,2,2,2,6,Other
16310,2010-10-21 14:47:00,2,460.08,413,1,2,2,5,At-Risk
16311,2011-11-22 08:54:00,2,616.26,16,4,2,2,8,Other
16312,2010-10-03 14:15:00,1,171.15,431,1,1,1,3,At-Risk
16313,2011-12-06 13:02:00,2,274.15,2,4,2,1,7,Other
16314,2010-11-15 12:06:00,3,1491.4,388,1,3,3,7,At-Risk
16315,2011-01-13 11:57:00,2,402.71,329,2,2,2,6,Other
16316,2011-10-06 13:48:00,13,5744.91,63,3,4,4,11,High-Value
16317,2011-08-12 12:46:00,5,2192.51,118,2,3,3,8,Other
16318,2011-11-04 13:05:00,1,328.15,34,3,1,1,5,One-Time
16319,2011-05-06 11:27:00,1,404.4,216,2,1,2,5,Other
16320,2011-06-20 15:25:00,6,5628.99,171,2,3,4,9,High-Value
16321,2011-09-28 14:55:00,7,604.55,71,3,4,2,9,High-Value
16322,2011-12-08 15:41:00,2,326.75,0,4,2,1,7,Other
16323,2011-05-27 14:48:00,2,353.66,195,2,2,2,6,Other
16324,2011-08-03 12:58:00,3,408.59,127,2,3,2,7,Other
16325,2011-10-24 08:48:00,12,3597.5,45,3,4,4,11,High-Value
16326,2011-12-04 10:11:00,24,4626.25,4,4,4,4,12,High-Value
16327,2011-11-25 13:23:00,16,10129.04,13,4,4,4,12,High-Value
16328,2010-05-25 14:02:00,1,310.83,562,1,1,1,3,At-Risk
16329,2010-10-08 12:44:00,4,1664.92,426,1,3,3,7,At-Risk
16330,2011-11-22 12:24:00,7,625.38,16,4,4,2,10,High-Value
16331,2010-10-03 13:47:00,6,2037.7,431,1,3,3,7,At-Risk
16332,2011-11-11 14:22:00,11,1997.49,27,3,4,3,10,High-Value
16333,2011-12-02 12:19:00,22,26626.8,6,4,4,4,12,High-Value
16334,2010-08-04 16:38:00,1,263.73,491,1,1,1,3,At-Risk
16335,2010-06-06 11:35:00,7,2753.52,550,1,4,4,9,High-Value
16336,2010-10-15 12:32:00,4,3517.69,419,1,3,4,8,At-Risk
16337,2011-11-03 10:03:00,1,151.05,35,3,1,1,5,One-Time
16338,2011-07-05 13:56:00,1,214.8,156,2,1,1,4,One-Time
16339,2011-02-28 13:41:00,1,94.05,283,2,1,1,4,One-Time
16340,2011-08-24 14:53:00,3,1496.24,106,2,3,3,8,Other
16341,2011-11-15 09:12:00,7,3850.79,23,4,4,4,12,High-Value
16342,2011-09-25 14:36:00,4,322.41,74,3,3,1,7,Loyal
16343,2011-11-23 17:45:00,3,614.12,15,4,3,2,9,High-Value
16344,2011-07-04 15:50:00,4,842.42,157,2,3,2,7,Other
16345,2011-10-26 16:03:00,2,1178.79,43,3,2,3,8,Other
16346,2010-11-19 15:55:00,1,224.51,384,1,1,1,3,At-Risk
16347,2011-11-28 13:14:00,11,3442.96,10,4,4,4,12,High-Value
16348,2011-11-07 15:44:00,8,1742.08,31,3,4,3,10,High-Value
16349,2011-02-22 12:40:00,1,53.5,289,2,1,1,4,One-Time
16350,2011-11-18 15:53:00,9,2253.89,20,4,4,4,12,High-Value
16351,2011-01-11 10:26:00,13,3330.03,331,2,4,4,10,High-Value
16352,2011-11-22 10:32:00,2,494.44,16,4,2,2,8,Other
16353,2011-12-06 12:23:00,38,9795.46,2,4,4,4,12,High-Value
16354,2011-10-07 14:28:00,5,1119.46,62,3,3,3,9,High-Value
16355,2010-11-29 14:21:00,1,416.35,374,2,1,2,5,Other
16356,2011-05-26 11:51:00,6,415.87,196,2,3,2,7,Other
16357,2011-11-06 16:04:00,4,868.37,32,3,3,3,9,High-Value
16358,2011-12-08 15:09:00,5,2919.65,0,4,3,4,11,High-Value
16359,2011-12-02 17:04:00,16,2697.75,6,4,4,4,12,High-Value
16360,2011-12-05 12:16:00,6,3450.41,3,4,3,4,11,High-Value
16361,2011-11-30 12:32:00,4,891.21,8,4,3,3,10,High-Value
16362,2011-11-07 13:01:00,6,922.16,31,3,3,3,9,High-Value
16363,2011-10-17 14:14:00,1,109.36,52,3,1,1,5,One-Time
16364,2011-11-28 11:27:00,2,705.79,10,4,2,2,8,Other
16365,2011-11-22 11:24:00,15,3167.34,16,4,4,4,12,High-Value
16366,2011-11-21 08:19:00,4,1548.13,17,4,3,3,10,High-Value
16367,2011-11-02 13:13:00,3,1350.48,36,3,3,3,9,High-Value
16368,2011-12-07 13:12:00,3,621.44,1,4,3,2,9,High-Value
16369,2011-11-21 16:25:00,7,2654.48,17,4,4,4,12,High-Value
16370,2011-09-18 15:55:00,4,1301.91,81,3,3,3,9,High-Value
16371,2010-09-17 12:09:00,1,157.2,447,1,1,1,3,At-Risk
16372,2011-11-06 13:08:00,5,1290.31,32,3,3,3,9,High-Value
16373,2010-11-22 15:50:00,2,309.49,381,1,2,1,4,At-Risk
16374,2011-10-04 15:21:00,5,1709.55,65,3,3,3,9,High-Value
16375,2010-08-26 14:25:00,2,104.0,469,1,2,1,4,At-Risk
16376,2011-12-01 11:38:00,2,974.96,7,4,2,3,9,High-Value
16377,2011-03-17 15:41:00,2,1308.48,266,2,2,3,7,Other
16378,2011-04-06 15:07:00,3,362.95,246,2,3,2,7,Other
16379,2011-12-05 15:38:00,4,2157.4,3,4,3,3,10,High-Value
16380,2011-10-09 15:40:00,1,1743.15,60,3,1,3,7,Other
16381,2010-11-09 09:56:00,2,247.85,394,1,2,1,4,At-Risk
16382,2010-10-27 16:23:00,2,353.1,407,1,2,2,5,At-Risk
16383,2011-09-26 12:45:00,7,2887.99,73,3,4,4,11,High-Value
16384,2011-09-11 11:19:00,4,1358.95,88,3,3,3,9,High-Value
16385,2011-10-10 13:12:00,5,881.35,59,3,3,3,9,High-Value
16386,2011-11-11 12:28:00,3,1068.16,27,3,3,3,9,High-Value
16387,2011-01-21 11:34:00,5,882.46,321,2,3,3,8,Other
16388,2010-02-24 10:20:00,1,186.05,652,1,1,1,3,At-Risk
16389,2011-10-17 14:41:00,4,1382.07,52,3,3,3,9,High-Value
16390,2010-06-21 10:11:00,3,467.5,535,1,3,2,6,At-Risk
16391,2010-11-04 12:27:00,4,1048.86,399,1,3,3,7,At-Risk
16392,2011-03-15 12:11:00,3,755.45,268,2,3,2,7,Other
16393,2011-12-07 12:51:00,23,5297.77,1,4,4,4,12,High-Value
16394,2011-10-14 09:48:00,5,1555.34,55,3,3,3,9,High-Value
16395,2011-10-10 12:50:00,14,3517.56,59,3,4,4,11,High-Value
16396,2010-08-20 14:17:00,1,137.8,475,1,1,1,3,At-Risk
16397,2010-03-21 15:36:00,1,123.13,627,1,1,1,3,At-Risk
16398,2011-07-08 15:16:00,2,1705.8,153,2,2,3,7,Other
16399,2011-11-20 16:12:00,3,628.42,18,4,3,2,9,High-Value
16400,2011-09-06 12:27:00,9,3059.85,93,3,4,4,11,High-Value
16401,2011-12-08 18:15:00,23,6847.45,0,4,4,4,12,High-Value
16402,2011-03-20 12:25:00,2,293.45,263,2,2,1,5,Other
16403,2011-01-31 13:39:00,1,177.5,311,2,1,1,4,One-Time
16404,2011-09-30 14:55:00,1,443.05,69,3,1,2,6,Other
16405,2011-02-10 15:24:00,2,167.25,301,2,2,1,5,Other
16406,2011-11-21 11:57:00,3,528.36,17,4,3,2,9,High-Value
16407,2011-11-27 11:05:00,14,2761.65,11,4,4,4,12,High-Value
16408,2010-04-27 14:08:00,1,231.93,590,1,1,1,3,At-Risk
16409,2011-11-03 16:45:00,12,5652.74,35,3,4,4,11,High-Value
16410,2009-12-05 14:51:00,1,130.32,733,1,1,1,3,At-Risk
16411,2011-11-20 13:23:00,4,756.39,18,4,3,2,9,High-Value
16412,2011-10-17 12:35:00,5,593.19,52,3,3,2,8,Loyal
16413,2011-10-14 12:08:00,2,522.03,55,3,2,2,7,Other
16414,2011-11-18 09:42:00,5,551.21,20,4,3,2,9,High-Value
16415,2011-10-26 13:35:00,3,696.76,43,3,3,2,8,Loyal
16416,2011-11-13 12:50:00,9,2957.88,25,3,4,4,11,High-Value
16417,2010-08-04 09:08:00,1,35.7,491,1,1,1,3,At-Risk
16418,2011-10-26 12:39:00,5,1028.74,43,3,3,3,9,High-Value
16419,2011-08-19 12:33:00,8,1463.7,111,2,4,3,9,High-Value
16420,2010-11-08 15:15:00,1,75.0,395,1,1,1,3,At-Risk
16421,2010-11-28 13:31:00,3,526.27,375,2,3,2,7,Other
16422,2011-11-22 14:00:00,108,61728.87,16,4,4,4,12,High-Value
16423,2011-11-15 09:21:00,1,346.12,23,4,1,2,7,Other
16424,2011-06-01 13:40:00,2,443.06,190,2,2,2,6,Other
16425,2011-02-10 14:30:00,1,302.7,301,2,1,1,4,One-Time
16426,2011-12-07 14:01:00,10,1863.76,1,4,4,3,11,High-Value
16427,2011-03-21 17:10:00,2,241.06,262,2,2,1,5,Other
16428,2010-10-22 12:22:00,3,638.49,412,1,3,2,6,At-Risk
16429,2011-08-25 13:54:00,1,284.55,105,2,1,1,4,One-Time
16430,2011-10-13 14:47:00,6,1102.94,56,3,3,3,9,High-Value
16431,2011-05-10 14:09:00,3,623.28,212,2,3,2,7,Other
16432,2011-10-06 13:59:00,1,287.4,63,3,1,1,5,One-Time
16433,2011-11-11 14:09:00,2,384.52,27,3,2,2,7,Other
16434,2011-11-10 14:28:00,12,2673.69,28,3,4,4,11,High-Value
16435,2010-07-15 18:22:00,3,1003.07,511,1,3,3,7,At-Risk
16436,2010-02-09 13:19:00,3,319.14,667,1,3,1,5,At-Risk
16437,2010-11-23 16:59:00,2,301.25,380,1,2,1,4,At-Risk
16438,2011-12-04 10:51:00,5,798.35,4,4,3,2,9,High-Value
16439,2009-12-17 14:22:00,1,310.7,721,1,1,1,3,At-Risk
16440,2011-12-02 12:02:00,6,3856.97,6,4,3,4,11,High-Value
16441,2011-10-03 17:48:00,5,1013.18,66,3,3,3,9,High-Value
16442,2011-12-08 11:43:00,5,891.98,0,4,3,3,10,High-Value
16443,2010-07-07 11:57:00,1,162.24,519,1,1,1,3,At-Risk
16444,2011-10-24 13:50:00,17,3625.88,45,3,4,4,11,High-Value
16445,2011-11-06 12:32:00,4,583.16,32,3,3,2,8,Loyal
16446,2011-12-09 09:15:00,2,168472.5,-1,4,2,4,10,High-Value
16447,2011-07-27 12:45:00,3,727.1,134,2,3,2,7,Other
16448,2011-05-25 16:28:00,2,361.12,197,2,2,2,6,Other
16449,2011-05-26 10:25:00,2,707.69,196,2,2,2,6,Other
16450,2011-07-13 11:47:00,3,1505.73,148,2,3,3,8,Other
16451,2011-09-13 09:17:00,3,1013.15,86,3,3,3,9,High-Value
16452,2010-03-19 12:39:00,2,332.17,629,1,2,1,4,At-Risk
16453,2010-06-27 12:46:00,2,251.71,529,1,2,1,4,At-Risk
16454,2011-10-06 16:57:00,3,29.95,63,3,3,1,7,Loyal
16455,2011-10-07 12:17:00,11,3995.57,62,3,4,4,11,High-Value
16456,2011-09-01 13:50:00,13,6000.94,98,2,4,4,10,High-Value
16457,2011-05-05 13:19:00,1,208.36,217,2,1,1,4,One-Time
16458,2011-12-07 09:34:00,30,5690.89,1,4,4,4,12,High-Value
16459,2009-12-10 12:42:00,1,71.79,728,1,1,1,3,At-Risk
16460,2011-11-11 13:46:00,3,811.23,27,3,3,2,8,Loyal
16461,2011-06-15 12:07:00,3,1539.83,176,2,3,3,8,Other
16462,2011-09-27 10:24:00,3,136.0,72,3,3,1,7,Loyal
16463,2011-11-18 14:01:00,4,1422.4,20,4,3,3,10,High-Value
16464,2011-11-20 12:11:00,3,1298.66,18,4,3,3,10,High-Value
16465,2010-10-15 09:27:00,2,746.24,419,1,2,2,5,At-Risk
16466,2011-11-06 11:35:00,15,3767.09,32,3,4,4,11,High-Value
16467,2010-07-19 11:49:00,7,2869.16,507,1,4,4,9,High-Value
16468,2011-09-26 14:13:00,3,787.52,73,3,3,2,8,Loyal
16469,2011-11-16 12:25:00,5,803.9,22,4,3,2,9,High-Value
16470,2011-10-19 12:11:00,11,2416.85,50,3,4,4,11,High-Value
16471,2011-03-10 09:41:00,4,1189.98,273,2,3,3,8,Other
16472,2010-10-01 13:56:00,2,789.6,433,1,2,2,5,At-Risk
16473,2011-06-28 09:10:00,4,470.83,163,2,3,2,7,Other
16474,2011-12-02 13:02:00,7,1810.49,6,4,4,3,11,High-Value
16475,2011-09-12 14:37:00,4,544.3,87,3,3,2,8,Loyal
16476,2010-10-04 10:29:00,1,350.35,430,1,1,2,4,At-Risk
16477,2011-10-07 09:44:00,11,4094.37,62,3,4,4,11,High-Value
16478,2011-11-14 15:51:00,3,331.0,24,4,3,1,8,Loyal
16479,2011-11-29 13:40:00,2,300.83,9,4,2,1,7,Other
16480,2011-09-25 11:40:00,1,769.29,74,3,1,2,6,Other
16481,2010-01-26 13:09:00,1,453.38,681,1,1,2,4,At-Risk
16482,2011-11-24 12:33:00,1,220.62,14,4,1,1,6,One-Time
16483,2011-05-31 13:08:00,1,139.35,191,2,1,1,4,One-Time
16484,2011-06-19 12:06:00,2,404.3,172,2,2,2,6,Other
16485,2011-09-23 15:50:00,5,2287.19,76,3,3,4,10,High-Value
16486,2010-06-20 12:16:00,1,134.36,536,1,1,1,3,At-Risk
16487,2010-05-11 13:38:00,2,209.4,576,1,2,1,4,At-Risk
16488,2011-11-06 13:42:00,3,498.8,32,3,3,2,8,Loyal
16489,2010-11-24 14:40:00,2,303.7,379,1,2,1,4,At-Risk
16490,2010-09-29 16:30:00,1,205.41,435,1,1,1,3,At-Risk
16491,2011-10-24 10:18:00,2,1533.16,45,3,2,3,8,Other
16492,2010-06-17 08:20:00,1,385.56,539,1,1,2,4,At-Risk
16493,2011-09-21 11:10:00,7,2132.09,78,3,4,3,10,High-Value
16494,2011-02-16 12:49:00,1,826.53,295,2,1,2,5,Other
16495,2011-12-06 13:20:00,3,648.26,2,4,3,2,9,High-Value
16496,2011-12-01 10:31:00,6,2330.77,7,4,3,4,11,High-Value
16497,2011-10-21 10:55:00,23,6695.28,48,3,4,4,11,High-Value
16498,2011-07-01 15:07:00,2,100.97,160,2,2,1,5,Other
16499,2010-12-14 13:31:00,8,2578.34,359,2,4,4,10,High-Value
16500,2011-12-05 12:04:00,9,843.91,3,4,4,2,10,High-Value
16501,2010-11-21 14:10:00,1,1191.23,382,1,1,3,5,At-Risk
16502,2010-03-29 13:44:00,2,258.55,619,1,2,1,4,At-Risk
16503,2011-08-25 11:46:00,11,3614.34,105,2,4,4,10,High-Value
16504,2011-11-14 15:18:00,1,465.88,24,4,1,2,7,Other
16505,2011-11-08 12:14:00,1,777.6,30,3,1,2,6,Other
16506,2011-11-20 12:17:00,2,90.3,18,4,2,1,7,Other
16507,2010-05-16 12:56:00,1,142.71,571,1,1,1,3,At-Risk
16508,2010-03-19 13:41:00,1,240.95,629,1,1,1,3,At-Risk
16509,2011-02-16 09:25:00,1,363.7,295,2,1,2,5,Other
16510,2010-12-02 13:39:00,6,1757.25,371,2,3,3,8,Other
16511,2011-11-18 10:41:00,6,1758.49,20,4,3,3,10,High-Value
16513,2011-12-05 10:18:00,4,874.59,3,4,3,3,10,High-Value
16515,2011-10-18 13:10:00,10,3179.06,51,3,4,4,11,High-Value
16516,2011-11-09 14:59:00,1,101.7,29,3,1,1,5,One-Time
16517,2011-03-07 13:50:00,1,162.7,276,2,1,1,4,One-Time
16518,2011-10-09 15:04:00,4,959.37,60,3,3,3,9,High-Value
16519,2011-11-14 15:41:00,4,436.96,24,4,3,2,9,High-Value
16520,2011-06-06 13:24:00,6,2148.38,185,2,3,3,8,Other
16521,2010-10-20 13:09:00,3,1136.36,414,1,3,3,7,At-Risk
16522,2010-09-30 10:54:00,2,433.36,434,1,2,2,5,At-Risk
16523,2011-12-08 09:06:00,28,11916.33,0,4,4,4,12,High-Value
16524,2010-09-19 13:37:00,2,306.19,445,1,2,1,4,At-Risk
16525,2011-12-07 15:07:00,48,24151.3,1,4,4,4,12,High-Value
16526,2011-06-21 12:02:00,2,717.21,170,2,2,2,6,Other
16527,2011-09-19 16:21:00,2,1232.94,80,3,2,3,8,Other
16528,2011-12-06 12:45:00,1,244.41,2,4,1,1,6,One-Time
16529,2011-06-02 17:23:00,4,1986.8,189,2,3,3,8,Other
16530,2010-02-09 15:30:00,1,48.35,667,1,1,1,3,At-Risk
16531,2011-11-17 16:29:00,11,2298.33,21,4,4,4,12,High-Value
16532,2011-11-22 11:08:00,5,8756.64,16,4,3,4,11,High-Value
16533,2011-11-20 13:08:00,3,1082.81,18,4,3,3,10,High-Value
16534,2010-03-07 15:47:00,1,635.9,641,1,1,2,4,At-Risk
16535,2011-12-04 15:18:00,2,952.04,4,4,2,3,9,High-Value
16536,2011-08-21 15:54:00,1,548.12,109,2,1,2,5,Other
16537,2010-03-08 13:41:00,1,10.55,640,1,1,1,3,At-Risk
16538,2010-06-16 16:59:00,3,395.07,540,1,3,2,6,At-Risk
16539,2011-12-07 08:41:00,10,3289.66,1,4,4,4,12,High-Value
16540,2010-10-21 17:22:00,1,205.75,413,1,1,1,3,At-Risk
16541,2009-12-04 13:22:00,1,424.03,734,1,1,2,4,At-Risk
16542,2011-10-17 10:47:00,2,257.32,52,3,2,1,6,Other
16543,2010-04-27 11:38:00,1,292.21,590,1,1,1,3,At-Risk
16544,2010-07-08 11:11:00,4,376.7,518,1,3,2,6,At-Risk
16545,2011-06-28 10:37:00,2,689.82,163,2,2,2,6,Other
16546,2011-02-22 11:20:00,5,5307.07,289,2,3,4,9,High-Value
16547,2010-06-11 13:02:00,1,104.26,545,1,1,1,3,At-Risk
16548,2010-04-19 16:15:00,1,30.15,598,1,1,1,3,At-Risk
16549,2011-11-29 15:06:00,34,12781.8,9,4,4,4,12,High-Value
16550,2011-08-23 11:12:00,18,8807.68,107,2,4,4,10,High-Value
16551,2011-09-05 09:38:00,7,2237.12,94,3,4,3,10,High-Value
16552,2011-04-11 10:04:00,2,379.73,241,2,2,2,6,Other
16553,2011-06-29 15:42:00,33,16584.01,162,2,4,4,10,High-Value
16554,2011-10-28 14:51:00,8,2841.72,41,3,4,4,11,High-Value
16555,2011-11-04 14:31:00,6,1915.68,34,3,3,3,9,High-Value
16556,2011-10-04 11:36:00,17,8012.58,65,3,4,4,11,High-Value
16557,2011-11-15 14:04:00,2,281.85,23,4,2,1,7,Other
16558,2011-12-09 10:20:00,38,13304.11,-1,4,4,4,12,High-Value
16559,2010-11-07 13:52:00,1,175.0,396,1,1,1,3,At-Risk
16560,2011-11-13 10:35:00,8,3048.38,25,3,4,4,11,High-Value
16561,2011-12-04 11:50:00,2,511.12,4,4,2,2,8,Other
16562,2010-08-20 11:45:00,1,223.86,475,1,1,1,3,At-Risk
16563,2011-10-17 11:51:00,6,4412.56,52,3,3,4,10,High-Value
16564,2010-05-19 14:41:00,1,87.8,568,1,1,1,3,At-Risk
16565,2010-12-10 15:21:00,4,773.05,363,2,3,2,7,Other
16566,2011-11-24 16:34:00,5,614.66,14,4,3,2,9,High-Value
16567,2011-05-29 13:57:00,2,865.6,193,2,2,3,7,Other
16568,2010-10-08 10:54:00,2,1020.9,426,1,2,3,6,At-Risk
16569,2011-12-06 15:32:00,5,1455.23,2,4,3,3,10,High-Value
16570,2011-11-24 17:02:00,20,7434.31,14,4,4,4,12,High-Value
16571,2011-11-13 11:46:00,10,4248.74,25,3,4,4,11,High-Value
16572,2011-08-04 16:34:00,3,1009.6,126,2,3,3,8,Other
16573,2011-09-16 09:13:00,2,663.61,83,3,2,2,7,Other
16574,2011-09-29 13:39:00,3,1301.78,70,3,3,3,9,High-Value
16576,2010-10-15 13:37:00,2,540.87,419,1,2,2,5,At-Risk
16577,2010-02-11 09:45:00,1,380.0,665,1,1,2,4,At-Risk
16578,2010-03-23 15:11:00,1,156.6,625,1,1,1,3,At-Risk
16579,2010-10-10 11:58:00,1,295.05,424,1,1,1,3,At-Risk
16581,2011-06-10 10:05:00,1,105.84,181,2,1,1,4,One-Time
16582,2011-08-18 17:02:00,1,313.62,112,2,1,1,4,One-Time
16583,2010-12-01 12:03:00,2,297.95,372,2,2,1,5,Other
16584,2011-09-20 13:45:00,5,3156.17,79,3,3,4,10,High-Value
16585,2010-04-25 10:34:00,2,341.59,592,1,2,2,5,At-Risk
16586,2011-04-05 09:32:00,3,1462.78,247,2,3,3,8,Other
16587,2011-04-21 15:51:00,1,225.15,231,2,1,1,4,One-Time
16588,2010-11-18 17:56:00,4,1361.28,385,1,3,3,7,At-Risk
16589,2011-09-29 14:50:00,4,612.36,70,3,3,2,8,Loyal
16590,2010-11-04 09:06:00,2,605.9,399,1,2,2,5,At-Risk
16591,2011-10-02 10:43:00,1,213.5,67,3,1,1,5,One-Time
16592,2011-12-05 13:49:00,28,7807.91,3,4,4,4,12,High-Value
16593,2011-10-20 12:41:00,8,1071.14,49,3,4,3,10,High-Value
16594,2011-09-25 14:08:00,1,181.09,74,3,1,1,5,One-Time
16595,2011-10-09 13:15:00,5,1757.75,60,3,3,3,9,High-Value
16596,2011-11-24 10:02:00,4,458.98,14,4,3,2,9,High-Value
16597,2011-12-05 15:44:00,1,90.04,3,4,1,1,6,One-Time
16598,2011-02-27 11:42:00,1,145.05,284,2,1,1,4,One-Time
16599,2010-11-19 12:45:00,1,172.8,384,1,1,1,3,At-Risk
16600,2011-12-05 16:00:00,13,2153.41,3,4,4,3,11,High-Value
16601,2011-10-30 11:09:00,3,675.83,39,3,3,2,8,Loyal
16602,2011-11-03 15:54:00,2,763.33,35,3,2,2,7,Other
16603,2011-09-26 10:06:00,2,482.47,73,3,2,2,7,Other
16604,2010-05-26 09:10:00,2,432.45,561,1,2,2,5,At-Risk
16605,2009-12-15 19:03:00,1,60.48,723,1,1,1,3,At-Risk
16606,2010-10-31 13:57:00,2,357.66,403,1,2,2,5,At-Risk
16607,2011-11-22 10:24:00,25,5706.87,16,4,4,4,12,High-Value
16608,2010-09-12 11:44:00,2,1286.62,452,1,2,3,6,At-Risk
16609,2011-11-24 13:32:00,7,5493.46,14,4,4,4,12,High-Value
16610,2011-05-04 13:13:00,1,75.66,218,2,1,1,4,One-Time
16611,2011-06-06 15:46:00,6,1785.13,185,2,3,3,8,Other
16612,2011-11-07 07:38:00,9,3245.43,31,3,4,4,11,High-Value
16613,2011-09-30 15:52:00,1,618.59,69,3,1,2,6,Other
16614,2011-06-10 11:36:00,3,1179.79,181,2,3,3,8,Other
16615,2010-03-23 15:13:00,1,291.5,625,1,1,1,3,At-Risk
16616,2011-11-24 16:31:00,2,500.42,14,4,2,2,8,Other
16617,2011-04-18 10:35:00,1,151.85,234,2,1,1,4,One-Time
16618,2011-11-08 13:52:00,5,2647.59,30,3,3,4,10,High-Value
16619,2011-03-21 08:18:00,4,1938.33,262,2,3,3,8,Other
16620,2011-12-06 12:19:00,6,1758.93,2,4,3,3,10,High-Value
16621,2011-10-19 11:38:00,4,813.48,50,3,3,2,8,Loyal
16622,2010-06-14 10:44:00,1,225.4,542,1,1,1,3,At-Risk
16623,2011-04-08 10:09:00,4,1015.24,244,2,3,3,8,Other
16624,2011-09-20 12:39:00,2,810.57,79,3,2,2,7,Other
16625,2011-03-10 12:50:00,5,1654.03,273,2,3,3,8,Other
16626,2011-12-09 11:56:00,17,4413.1,-1,4,4,4,12,High-Value
16627,2011-09-21 14:38:00,1,322.8,78,3,1,1,5,One-Time
16628,2011-11-10 12:45:00,7,2318.1,28,3,4,4,11,High-Value
16629,2011-09-27 10:34:00,2,408.63,72,3,2,2,7,Other
16630,2010-10-28 14:30:00,1,106.8,406,1,1,1,3,At-Risk
16631,2010-08-15 11:20:00,7,1892.52,480,1,4,3,8,At-Risk
16632,2010-08-11 11:39:00,2,406.4,484,1,2,2,5,At-Risk
16633,2011-11-22 13:41:00,6,2883.1,16,4,3,4,11,High-Value
16634,2011-05-01 12:09:00,6,1649.81,221,2,3,3,8,Other
16635,2010-10-29 09:41:00,1,473.0,405,1,1,2,4,At-Risk
16636,2010-09-27 13:13:00,4,3802.04,437,1,3,4,8,At-Risk
16637,2011-11-07 13:17:00,4,1154.47,31,3,3,3,9,High-Value
16638,2011-11-17 11:09:00,15,2380.13,21,4,4,4,12,High-Value
16639,2011-11-08 13:20:00,4,1747.98,30,3,3,3,9,High-Value
16640,2010-11-07 10:48:00,1,179.4,396,1,1,1,3,At-Risk
16641,2011-08-26 12:49:00,2,554.5,104,2,2,2,6,Other
16642,2011-12-05 11:31:00,3,1077.45,3,4,3,3,10,High-Value
16643,2011-04-08 08:24:00,2,923.11,244,2,2,3,7,Other
16644,2011-06-15 12:39:00,2,833.78,176,2,2,2,6,Other
16645,2009-12-04 09:49:00,1,160.39,734,1,1,1,3,At-Risk
16646,2010-09-16 13:28:00,1,678.8,448,1,1,2,4,At-Risk
16647,2011-06-23 11:47:00,4,541.9,168,2,3,2,7,Other
16648,2011-10-28 08:58:00,3,672.8,41,3,3,2,8,Loyal
16649,2010-07-07 15:41:00,1,306.58,519,1,1,1,3,At-Risk
16650,2011-09-29 09:51:00,7,1916.11,70,3,4,3,10,High-Value
16651,2010-05-02 11:46:00,1,136.2,585,1,1,1,3,At-Risk
16652,2011-10-12 09:38:00,16,17550.39,57,3,4,4,11,High-Value
16653,2011-11-23 14:51:00,2,1212.66,15,4,2,3,9,High-Value
16654,2011-07-21 15:23:00,8,1484.07,140,2,4,3,9,High-Value
16655,2011-11-22 11:25:00,13,6423.26,16,4,4,4,12,High-Value
16656,2011-11-17 14:43:00,30,16833.17,21,4,4,4,12,High-Value
16657,2011-11-30 11:48:00,4,874.43,8,4,3,3,10,High-Value
16658,2010-12-06 13:47:00,5,680.83,367,2,3,2,7,Other
16659,2011-06-03 15:03:00,1,39.12,188,2,1,1,4,One-Time
16660,2011-11-23 14:53:00,7,1879.55,15,4,4,3,11,High-Value
16661,2010-06-17 15:24:00,4,932.76,539,1,3,3,7,At-Risk
16662,2010-11-10 16:56:00,1,151.05,393,1,1,1,3,At-Risk
16663,2009-12-10 13:12:00,1,165.0,728,1,1,1,3,At-Risk
16664,2010-05-19 17:11:00,1,109.2,568,1,1,1,3,At-Risk
16665,2010-12-12 14:03:00,1,135.4,361,2,1,1,4,One-Time
16666,2011-11-20 14:01:00,2,217.71,18,4,2,1,7,Other
16667,2011-10-02 15:26:00,2,567.18,67,3,2,2,7,Other
16668,2011-11-24 17:43:00,13,862.42,14,4,4,3,11,High-Value
16669,2011-11-16 12:26:00,2,1344.48,22,4,2,3,9,High-Value
16670,2011-11-23 09:34:00,20,8030.15,15,4,4,4,12,High-Value
16671,2011-11-11 13:40:00,3,1692.27,27,3,3,3,9,High-Value
16672,2011-12-07 16:29:00,20,8134.94,1,4,4,4,12,High-Value
16673,2010-01-29 14:22:00,1,171.13,678,1,1,1,3,At-Risk
16674,2011-10-16 11:31:00,2,304.24,53,3,2,1,6,Other
16675,2010-09-24 12:15:00,2,608.86,440,1,2,2,5,At-Risk
16676,2011-11-06 12:01:00,6,2361.9,32,3,3,4,10,High-Value
16677,2010-10-24 14:53:00,2,880.62,410,1,2,3,6,At-Risk
16678,2011-12-07 12:17:00,12,3109.99,1,4,4,4,12,High-Value
16679,2010-12-08 13:51:00,3,663.31,365,2,3,2,7,Other
16680,2011-10-27 17:35:00,3,821.45,42,3,3,2,8,Loyal
16681,2011-09-28 11:11:00,7,1921.84,71,3,4,3,10,High-Value
16682,2011-12-05 12:13:00,5,1028.0,3,4,3,3,10,High-Value
16683,2010-06-24 10:36:00,1,320.25,532,1,1,1,3,At-Risk
16684,2011-12-05 14:06:00,55,147142.77,3,4,4,4,12,High-Value
16685,2011-10-09 13:58:00,2,324.24,60,3,2,1,6,Other
16686,2011-10-23 13:49:00,16,4881.07,46,3,4,4,11,High-Value
16687,2010-11-14 11:46:00,1,157.63,389,1,1,1,3,At-Risk
16688,2011-12-08 15:24:00,4,1260.86,0,4,3,3,10,High-Value
16689,2011-09-25 11:39:00,2,422.6,74,3,2,2,7,Other
16690,2011-09-28 15:02:00,4,353.03,71,3,3,2,8,Loyal
16691,2010-10-17 15:03:00,2,178.83,417,1,2,1,4,At-Risk
16692,2011-03-28 14:46:00,4,1764.7,255,2,3,3,8,Other
16693,2011-10-02 11:10:00,5,1179.48,67,3,3,3,9,High-Value
16694,2009-12-16 15:45:00,1,98.3,722,1,1,1,3,At-Risk
16695,2010-05-27 12:36:00,2,191.9,560,1,2,1,4,At-Risk
16696,2011-07-27 14:23:00,4,657.9,134,2,3,2,7,Other
16697,2011-04-12 17:12:00,1,112.75,240,2,1,1,4,One-Time
16698,2011-04-27 10:52:00,2,1998.0,225,2,2,3,7,Other
16699,2010-11-24 14:38:00,7,994.6,379,1,4,3,8,At-Risk
16700,2011-12-01 11:00:00,25,8830.77,7,4,4,4,12,High-Value
16701,2011-12-01 11:10:00,26,9916.73,7,4,4,4,12,High-Value
16702,2010-10-20 14:10:00,4,1109.53,414,1,3,3,7,At-Risk
16704,2010-03-31 14:02:00,2,664.16,617,1,2,2,5,At-Risk
16705,2011-12-09 12:08:00,42,43515.05,-1,4,4,4,12,High-Value
16706,2011-11-02 13:50:00,3,531.35,36,3,3,2,8,Loyal
16707,2010-11-04 14:39:00,4,533.41,399,1,3,2,6,At-Risk
16708,2011-10-25 12:20:00,1,656.63,44,3,1,2,6,Other
16709,2011-09-16 10:56:00,14,9056.01,83,3,4,4,11,High-Value
16710,2011-11-20 14:50:00,22,5921.35,18,4,4,4,12,High-Value
16711,2011-12-06 16:32:00,9,2868.48,2,4,4,4,12,High-Value
16712,2011-11-30 13:48:00,13,4225.22,8,4,4,4,12,High-Value
16713,2011-11-21 12:36:00,32,14115.56,17,4,4,4,12,High-Value
16714,2011-01-26 13:46:00,3,1482.33,316,2,3,3,8,Other
16715,2011-09-22 18:15:00,2,625.52,77,3,2,2,7,Other
16716,2011-03-18 10:03:00,3,2149.68,265,2,3,3,8,Other
16717,2011-11-16 12:16:00,14,6663.68,22,4,4,4,12,High-Value
16718,2010-12-05 13:03:00,5,3006.08,368,2,3,4,9,High-Value
16719,2011-11-25 09:27:00,14,3508.62,13,4,4,4,12,High-Value
16720,2011-11-13 16:22:00,3,566.74,25,3,3,2,8,Loyal
16721,2011-03-22 16:08:00,1,292.47,261,2,1,1,4,One-Time
16722,2011-11-22 13:28:00,22,8189.56,16,4,4,4,12,High-Value
16723,2011-09-09 13:01:00,4,1231.36,90,3,3,3,9,High-Value
16724,2010-10-31 11:40:00,1,147.35,403,1,1,1,3,At-Risk
16725,2011-02-10 16:52:00,13,1686.81,301,2,4,3,9,High-Value
16726,2011-11-13 14:53:00,7,2063.88,25,3,4,3,10,High-Value
16727,2010-12-10 13:48:00,4,1377.77,363,2,3,3,8,Other
16728,2011-10-24 14:36:00,4,1048.28,45,3,3,3,9,High-Value
16729,2011-11-01 14:29:00,21,7202.01,37,3,4,4,11,High-Value
16730,2011-10-18 14:11:00,3,743.11,51,3,3,2,8,Loyal
16731,2010-03-01 15:05:00,1,170.3,647,1,1,1,3,At-Risk
16732,2011-11-08 09:54:00,4,4387.64,30,3,3,4,10,High-Value
16733,2010-06-28 10:12:00,1,259.68,528,1,1,1,3,At-Risk
16734,2011-10-18 13:44:00,3,646.76,51,3,3,2,8,Loyal
16735,2011-09-22 11:49:00,14,6217.41,77,3,4,4,11,High-Value
16736,2010-07-22 10:09:00,5,2956.56,504,1,3,4,8,At-Risk
16737,2011-10-17 13:03:00,2,835.2,52,3,2,2,7,Other
16738,2011-02-15 09:46:00,1,3.75,296,2,1,1,4,One-Time
16739,2011-06-16 09:17:00,2,786.43,175,2,2,2,6,Other
16740,2010-11-09 13:34:00,1,226.91,394,1,1,1,3,At-Risk
16741,2010-03-24 15:15:00,1,173.06,624,1,1,1,3,At-Risk
16742,2010-08-04 10:52:00,13,2334.97,491,1,4,4,9,High-Value
16743,2011-11-10 13:13:00,14,4212.15,28,3,4,4,11,High-Value
16744,2011-11-28 13:06:00,7,1291.91,10,4,4,3,11,High-Value
16745,2011-09-14 11:58:00,17,7180.7,85,3,4,4,11,High-Value
16746,2011-12-05 12:33:00,42,18045.05,3,4,4,4,12,High-Value
16747,2011-11-02 11:37:00,2,836.06,36,3,2,2,7,Other
16748,2011-11-22 10:17:00,14,3637.33,16,4,4,4,12,High-Value
16749,2010-04-27 13:06:00,2,4157.88,590,1,2,4,7,At-Risk
16750,2011-10-26 12:48:00,5,623.93,43,3,3,2,8,Loyal
16751,2011-11-09 10:48:00,1,1764.72,29,3,1,3,7,Other
16752,2010-12-02 12:18:00,1,207.5,371,2,1,1,4,One-Time
16753,2011-10-12 13:14:00,1,223.92,57,3,1,1,5,One-Time
16754,2010-12-02 17:38:00,29,65500.07,371,2,4,4,10,High-Value
16755,2011-08-17 13:21:00,7,2864.68,113,2,4,4,10,High-Value
16756,2011-05-09 09:33:00,7,1312.37,213,2,4,3,9,High-Value
16757,2011-01-25 11:59:00,2,270.48,317,2,2,1,5,Other
16758,2011-10-05 14:47:00,1,369.34,64,3,1,2,6,Other
16759,2011-12-02 12:42:00,3,789.79,6,4,3,2,9,High-Value
16760,2010-10-05 15:55:00,1,228.0,429,1,1,1,3,At-Risk
16761,2011-09-04 11:15:00,1,316.62,95,2,1,1,4,One-Time
16762,2011-11-20 11:43:00,3,1207.24,18,4,3,3,10,High-Value
16763,2011-05-25 11:52:00,2,964.7,197,2,2,3,7,Other
16764,2011-12-06 11:41:00,13,2790.95,2,4,4,4,12,High-Value
16765,2011-02-18 15:41:00,2,454.75,293,2,2,2,6,Other
16766,2011-03-11 15:22:00,2,1145.6,272,2,2,3,7,Other
16767,2011-11-09 09:42:00,15,8052.41,29,3,4,4,11,High-Value
16768,2011-10-23 10:38:00,9,1698.57,46,3,4,3,10,High-Value
16769,2011-03-24 13:41:00,4,1117.05,259,2,3,3,8,Other
16770,2011-10-13 12:21:00,9,1778.93,56,3,4,3,10,High-Value
16771,2011-11-06 13:28:00,10,3921.1,32,3,4,4,11,High-Value
16772,2010-10-12 13:19:00,3,3698.05,422,1,3,4,8,At-Risk
16773,2011-10-13 14:37:00,3,421.24,56,3,3,2,8,Loyal
16774,2011-10-03 12:41:00,8,1567.48,66,3,4,3,10,High-Value
16775,2011-11-29 15:22:00,16,2820.84,9,4,4,4,12,High-Value
16776,2011-10-10 13:04:00,2,592.51,59,3,2,2,7,Other
16777,2011-09-20 13:41:00,5,1292.18,79,3,3,3,9,High-Value
16778,2011-09-26 13:48:00,2,245.94,73,3,2,1,6,Other
16779,2011-12-07 14:54:00,53,32809.03,1,4,4,4,12,High-Value
16780,2011-08-31 16:09:00,3,596.4,99,2,3,2,7,Other
16781,2010-12-02 14:26:00,2,623.0,371,2,2,2,6,Other
16782,2011-11-29 13:20:00,38,9636.12,9,4,4,4,12,High-Value
16783,2010-09-29 11:53:00,1,391.95,435,1,1,2,4,At-Risk
16784,2011-11-20 12:20:00,5,892.33,18,4,3,3,10,High-Value
16785,2010-10-26 10:36:00,1,533.78,408,1,1,2,4,At-Risk
16786,2010-11-11 08:25:00,1,51.84,392,1,1,1,3,At-Risk
16787,2010-11-07 11:01:00,4,1017.53,396,1,3,3,7,At-Risk
16788,2011-08-08 14:53:00,5,1927.28,122,2,3,3,8,Other
16789,2011-12-01 15:12:00,1,80.8,7,4,1,1,6,One-Time
16790,2011-12-06 11:53:00,6,1545.62,2,4,3,3,10,High-Value
16791,2011-11-10 19:12:00,15,3944.88,28,3,4,4,11,High-Value
16792,2011-03-02 14:41:00,5,623.46,281,2,3,2,7,Other
16793,2011-10-13 15:08:00,1,243.84,56,3,1,1,5,One-Time
16794,2011-12-08 17:54:00,15,2050.68,0,4,4,3,11,High-Value
16795,2010-12-09 14:08:00,3,2062.41,364,2,3,3,8,Other
16796,2011-09-11 14:01:00,1,305.62,88,3,1,1,5,One-Time
16797,2010-11-11 19:14:00,5,1802.02,392,1,3,3,7,At-Risk
16798,2010-06-03 19:01:00,3,841.16,553,1,3,2,6,At-Risk
16799,2010-10-03 14:28:00,2,452.78,431,1,2,2,5,At-Risk
16800,2011-11-28 14:06:00,1,1162.65,10,4,1,3,8,Other
16801,2011-06-29 15:33:00,4,1594.23,162,2,3,3,8,Other
16802,2010-01-29 13:44:00,2,582.61,678,1,2,2,5,At-Risk
16803,2011-10-05 14:28:00,1,332.3,64,3,1,1,5,One-Time
16804,2011-11-16 16:43:00,3,536.99,22,4,3,2,9,High-Value
16805,2011-06-19 11:23:00,4,1076.34,172,2,3,3,8,Other
16806,2011-08-28 15:27:00,4,736.21,102,2,3,2,7,Other
16807,2011-07-20 12:00:00,6,2123.88,141,2,3,3,8,Other
16808,2011-09-01 19:34:00,2,288.42,98,2,2,1,5,Other
16809,2011-11-16 15:45:00,9,1727.43,22,4,4,3,11,High-Value
16810,2011-05-31 15:32:00,2,842.04,191,2,2,2,6,Other
16811,2011-12-05 11:39:00,2,547.07,3,4,2,2,8,Other
16812,2010-12-14 12:35:00,4,2392.0,359,2,3,4,9,High-Value
16813,2011-12-01 14:03:00,10,1652.18,7,4,4,3,11,High-Value
16814,2011-11-25 13:27:00,36,11914.95,13,4,4,4,12,High-Value
16815,2010-09-12 10:59:00,2,406.02,452,1,2,2,5,At-Risk
16816,2011-08-28 14:16:00,4,417.06,102,2,3,2,7,Other
16817,2011-12-07 11:03:00,13,2560.7,1,4,4,4,12,High-Value
16818,2011-11-29 10:41:00,11,3349.57,9,4,4,4,12,High-Value
16819,2010-08-31 17:37:00,2,182.59,464,1,2,1,4,At-Risk
16820,2011-09-05 12:06:00,1,497.61,94,3,1,2,6,Other
16821,2010-11-23 10:04:00,1,113.35,380,1,1,1,3,At-Risk
16822,2010-01-22 14:22:00,1,181.39,685,1,1,1,3,At-Risk
16823,2011-04-26 15:00:00,7,2243.09,226,2,4,4,10,High-Value
16824,2011-11-24 12:38:00,3,686.24,14,4,3,2,9,High-Value
16825,2011-11-01 11:51:00,5,1826.89,37,3,3,3,9,High-Value
16826,2011-10-19 14:05:00,1,341.7,50,3,1,2,6,Other
16827,2010-11-11 14:04:00,5,387.18,392,1,3,2,6,At-Risk
16828,2011-08-19 13:24:00,1,113.5,111,2,1,1,4,One-Time
16829,2011-07-06 10:48:00,2,513.32,155,2,2,2,6,Other
16830,2011-11-01 11:35:00,4,1207.5,37,3,3,3,9,High-Value
16831,2010-05-24 09:08:00,1,91.8,563,1,1,1,3,At-Risk
16832,2011-06-08 15:36:00,5,417.61,183,2,3,2,7,Other
16833,2011-12-08 14:39:00,6,2409.04,0,4,3,4,11,High-Value
16834,2011-04-26 09:37:00,2,898.96,226,2,2,3,7,Other
16835,2011-08-03 13:50:00,6,1456.66,127,2,3,3,8,Other
16836,2011-10-31 10:05:00,4,782.37,38,3,3,2,8,Loyal
16837,2011-11-08 14:27:00,11,3170.98,30,3,4,4,11,High-Value
16838,2011-05-26 13:13:00,4,1159.61,196,2,3,3,8,Other
16839,2011-12-01 09:03:00,44,21758.25,7,4,4,4,12,High-Value
16840,2010-04-15 15:48:00,2,139.85,602,1,2,1,4,At-Risk
16841,2011-11-03 11:51:00,12,4006.06,35,3,4,4,11,High-Value
16842,2011-08-31 10:42:00,3,1264.19,99,2,3,3,8,Other
16843,2011-10-28 09:06:00,35,19571.43,41,3,4,4,11,High-Value
16844,2010-05-26 10:29:00,2,614.34,561,1,2,2,5,At-Risk
16845,2010-03-31 13:09:00,1,253.88,617,1,1,1,3,At-Risk
16846,2011-10-20 13:55:00,3,842.41,49,3,3,2,8,Loyal
16847,2011-10-27 13:29:00,2,614.89,42,3,2,2,7,Other
16848,2011-10-18 08:42:00,4,1411.62,51,3,3,3,9,High-Value
16849,2011-06-06 09:16:00,1,124.57,185,2,1,1,4,One-Time
16850,2011-01-10 11:09:00,1,332.41,332,2,1,1,4,One-Time
16851,2011-12-05 13:32:00,3,342.45,3,4,3,2,9,High-Value
16852,2011-11-29 13:22:00,2,144.91,9,4,2,1,7,Other
16854,2010-10-18 16:31:00,2,1408.96,416,1,2,3,6,At-Risk
16855,2011-11-16 12:03:00,2,328.4,22,4,2,1,7,Other
16856,2011-11-25 08:59:00,3,358.49,13,4,3,2,9,High-Value
16857,2010-09-23 10:49:00,1,352.8,441,1,1,2,4,At-Risk
16858,2010-12-06 09:52:00,10,4292.59,367,2,4,4,10,High-Value
16859,2011-07-18 12:19:00,7,1932.41,143,2,4,3,9,High-Value
16860,2010-09-13 10:05:00,3,1610.62,451,1,3,3,7,At-Risk
16861,2011-10-11 09:05:00,5,946.59,58,3,3,3,9,High-Value
16862,2010-06-10 13:05:00,4,662.33,546,1,3,2,6,At-Risk
16863,2011-11-08 15:26:00,3,834.27,30,3,3,2,8,Loyal
16864,2010-10-01 16:16:00,2,409.25,433,1,2,2,5,At-Risk
16865,2010-11-03 11:34:00,1,130.95,400,1,1,1,3,At-Risk
16866,2011-07-22 10:06:00,3,207.74,139,2,3,1,6,Other
16867,2010-01-19 09:11:00,1,76.74,688,1,1,1,3,At-Risk
16868,2010-11-10 13:17:00,3,384.56,393,1,3,2,6,At-Risk
16869,2011-11-17 12:02:00,4,817.12,21,4,3,2,9,High-Value
16870,2010-08-27 13:53:00,1,450.16,468,1,1,2,4,At-Risk
16871,2011-11-17 19:27:00,6,2812.34,21,4,3,4,11,High-Value
16872,2011-09-23 16:05:00,6,1213.13,76,3,3,3,9,High-Value
16873,2011-12-05 12:05:00,12,14617.39,3,4,4,4,12,High-Value
16874,2010-11-25 13:08:00,1,209.89,378,2,1,1,4,One-Time
16875,2011-10-03 13:39:00,11,4234.53,66,3,4,4,11,High-Value
16876,2010-11-01 11:59:00,1,136.01,402,1,1,1,3,At-Risk
16877,2011-11-27 13:47:00,6,846.62,11,4,3,2,9,High-Value
16878,2011-09-16 17:39:00,1,13.3,83,3,1,1,5,One-Time
16880,2011-11-09 11:33:00,8,1813.21,29,3,4,3,10,High-Value
16881,2011-10-04 10:33:00,1,432.0,65,3,1,2,6,Other
16882,2011-10-04 10:42:00,3,705.12,65,3,3,2,8,Loyal
16883,2011-06-05 12:51:00,19,2246.06,186,2,4,4,10,High-Value
16884,2011-11-02 11:52:00,4,1070.97,36,3,3,3,9,High-Value
16885,2011-11-24 13:40:00,4,683.35,14,4,3,2,9,High-Value
16886,2010-09-09 15:08:00,1,134.0,455,1,1,1,3,At-Risk
16887,2011-11-04 14:07:00,3,658.17,34,3,3,2,8,Loyal
16888,2010-11-04 12:39:00,3,434.2,399,1,3,2,6,At-Risk
16889,2011-05-29 11:05:00,6,2526.65,193,2,3,4,9,High-Value
16890,2010-08-20 11:23:00,3,277.91,475,1,3,1,5,At-Risk
16891,2011-12-08 11:15:00,11,1727.94,0,4,4,3,11,High-Value
16892,2011-12-08 13:18:00,7,754.75,0,4,4,2,10,High-Value
16893,2010-12-08 12:06:00,2,249.47,365,2,2,1,5,Other
16894,2010-07-25 15:43:00,3,1306.96,501,1,3,3,7,At-Risk
16895,2011-10-06 12:15:00,5,1102.9,63,3,3,3,9,High-Value
16896,2010-06-02 15:40:00,1,103.95,554,1,1,1,3,At-Risk
16897,2011-02-13 15:02:00,2,289.78,298,2,2,1,5,Other
16898,2011-11-13 15:44:00,5,885.21,25,3,3,3,9,High-Value
16899,2011-12-02 12:03:00,8,1695.77,6,4,4,3,11,High-Value
16900,2011-11-23 10:32:00,3,882.16,15,4,3,3,10,High-Value
16901,2009-12-10 16:30:00,1,204.26,728,1,1,1,3,At-Risk
16902,2011-08-15 14:17:00,1,1706.88,115,2,1,3,6,Other
16903,2011-11-10 15:32:00,3,1041.75,28,3,3,3,9,High-Value
16904,2011-12-05 13:10:00,20,4656.56,3,4,4,4,12,High-Value
16905,2011-12-04 14:01:00,17,4704.27,4,4,4,4,12,High-Value
16906,2011-09-19 11:49:00,7,1410.07,80,3,4,3,10,High-Value
16907,2011-11-10 18:04:00,9,1470.89,28,3,4,3,10,High-Value
16908,2009-12-17 13:35:00,1,252.59,721,1,1,1,3,At-Risk
16909,2011-09-28 16:45:00,1,379.14,71,3,1,2,6,Other
16910,2011-12-05 12:51:00,8,1508.96,3,4,4,3,11,High-Value
16911,2010-03-14 12:18:00,2,255.25,634,1,2,1,4,At-Risk
16912,2011-11-11 12:18:00,15,4460.51,27,3,4,4,11,High-Value
16913,2011-02-22 12:56:00,3,423.91,289,2,3,2,7,Other
16914,2011-11-03 15:27:00,1,183.76,35,3,1,1,5,One-Time
16915,2011-11-30 16:39:00,11,1543.18,8,4,4,3,11,High-Value
16916,2011-11-16 12:08:00,4,896.12,22,4,3,3,10,High-Value
16917,2011-03-08 11:55:00,2,1851.88,275,2,2,3,7,Other
16918,2011-10-21 12:50:00,16,3206.54,48,3,4,4,11,High-Value
16919,2011-07-06 13:35:00,24,4909.66,155,2,4,4,10,High-Value
16920,2010-10-24 14:07:00,1,355.45,410,1,1,2,4,At-Risk
16921,2011-10-09 16:22:00,3,409.21,60,3,3,2,8,Loyal
16922,2010-05-16 11:24:00,1,611.08,571,1,1,2,4,At-Risk
16923,2011-11-27 13:00:00,32,13157.13,11,4,4,4,12,High-Value
16924,2011-11-18 12:53:00,3,829.89,20,4,3,2,9,High-Value
16925,2010-06-17 15:03:00,1,125.65,539,1,1,1,3,At-Risk
16926,2010-12-03 13:42:00,5,1169.61,370,2,3,3,8,Other
16927,2011-08-16 11:10:00,3,543.05,114,2,3,2,7,Other
16928,2011-09-20 15:10:00,26,3798.08,79,3,4,4,11,High-Value
16929,2011-12-06 08:37:00,7,1295.39,2,4,4,3,11,High-Value
16930,2011-11-13 16:13:00,3,378.89,25,3,3,2,8,Loyal
16931,2011-12-04 13:15:00,23,5032.22,4,4,4,4,12,High-Value
16932,2011-10-17 14:12:00,3,412.55,52,3,3,2,8,Loyal
16933,2011-12-08 12:54:00,9,3099.3,0,4,4,4,12,High-Value
16934,2011-10-16 12:40:00,6,2083.14,53,3,3,3,9,High-Value
16935,2010-11-23 09:16:00,3,530.86,380,1,3,2,6,At-Risk
16936,2011-11-14 11:04:00,2,548.29,24,4,2,2,8,Other
16937,2010-07-28 17:56:00,1,196.25,498,1,1,1,3,At-Risk
16938,2011-12-01 10:20:00,9,6995.36,7,4,4,4,12,High-Value
16939,2010-08-08 12:24:00,3,433.85,487,1,3,2,6,At-Risk
16940,2011-10-18 13:15:00,8,6427.66,51,3,4,4,11,High-Value
16941,2010-04-07 11:13:00,1,33.0,610,1,1,1,3,At-Risk
16942,2011-11-27 12:40:00,9,1904.99,11,4,4,3,11,High-Value
16943,2011-05-12 11:57:00,3,816.73,210,2,3,2,7,Other
16944,2010-04-09 11:03:00,1,101.36,608,1,1,1,3,At-Risk
16945,2011-11-18 11:39:00,33,8548.16,20,4,4,4,12,High-Value
16946,2010-11-21 14:06:00,5,1222.04,382,1,3,3,7,At-Risk
16947,2011-04-18 09:38:00,4,946.71,234,2,3,3,8,Other
16948,2011-07-24 12:46:00,7,868.77,137,2,4,3,9,High-Value
16949,2011-12-06 11:07:00,6,1286.27,2,4,3,3,10,High-Value
16950,2011-10-14 09:06:00,10,3533.77,55,3,4,4,11,High-Value
16951,2011-07-28 12:05:00,3,1277.75,133,2,3,3,8,Other
16952,2011-08-22 13:03:00,5,795.83,108,2,3,2,7,Other
16953,2011-11-09 15:54:00,1,20.8,29,3,1,1,5,One-Time
16954,2011-12-09 09:46:00,20,6081.88,-1,4,4,4,12,High-Value
16955,2011-06-08 10:36:00,6,1120.31,183,2,3,3,8,Other
16956,2011-11-22 08:56:00,1,308.74,16,4,1,1,6,One-Time
16957,2011-04-14 13:56:00,2,416.64,238,2,2,2,6,Other
16958,2010-09-30 14:25:00,1,778.49,434,1,1,2,4,At-Risk
16959,2011-09-13 15:03:00,1,117.35,86,3,1,1,5,One-Time
16960,2011-11-01 11:35:00,8,1988.93,37,3,4,3,10,High-Value
16961,2011-08-15 13:46:00,3,794.56,115,2,3,2,7,Other
16962,2010-10-26 11:36:00,1,251.04,408,1,1,1,3,At-Risk
16963,2011-06-05 13:48:00,1,110.55,186,2,1,1,4,One-Time
16964,2009-12-06 12:53:00,2,207.85,732,1,2,1,4,At-Risk
16965,2011-04-27 12:08:00,1,192.07,225,2,1,1,4,One-Time
16966,2011-12-01 13:40:00,7,2154.97,7,4,4,3,11,High-Value
16967,2011-06-03 14:24:00,1,319.02,188,2,1,1,4,One-Time
16968,2011-12-05 15:02:00,2,439.43,3,4,2,2,8,Other
16969,2011-10-31 13:12:00,3,650.41,38,3,3,2,8,Loyal
16970,2010-03-23 13:50:00,1,71.4,625,1,1,1,3,At-Risk
16971,2011-11-01 15:06:00,1,357.21,37,3,1,2,6,Other
16972,2010-11-22 10:59:00,2,749.0,381,1,2,2,5,At-Risk
16973,2010-11-18 13:56:00,1,127.0,385,1,1,1,3,At-Risk
16974,2010-07-05 10:18:00,2,365.5,521,1,2,2,5,At-Risk
16975,2010-10-12 17:53:00,3,926.12,422,1,3,3,7,At-Risk
16976,2011-03-17 16:33:00,1,251.52,266,2,1,1,4,One-Time
16977,2010-11-09 13:17:00,4,496.0,394,1,3,2,6,At-Risk
16978,2011-09-23 12:50:00,3,768.88,76,3,3,2,8,Loyal
16979,2011-12-06 12:21:00,9,2859.74,2,4,4,4,12,High-Value
16980,2011-03-29 16:36:00,3,1422.83,254,2,3,3,8,Other
16982,2011-10-10 12:28:00,1,384.06,59,3,1,2,6,Other
16983,2011-11-27 12:10:00,11,3490.53,11,4,4,4,12,High-Value
16984,2011-09-12 13:43:00,9,10350.53,87,3,4,4,11,High-Value
16985,2011-11-22 13:33:00,23,10923.16,16,4,4,4,12,High-Value
16986,2011-11-10 11:55:00,11,4888.75,28,3,4,4,11,High-Value
16987,2011-12-06 17:26:00,11,2499.45,2,4,4,4,12,High-Value
16988,2011-12-04 16:02:00,2,382.67,4,4,2,2,8,Other
16989,2011-12-02 16:39:00,6,1133.25,6,4,3,3,10,High-Value
16990,2011-05-05 08:30:00,2,344.0,217,2,2,2,6,Other
16991,2010-10-14 14:08:00,1,1041.21,420,1,1,3,5,At-Risk
16992,2011-11-29 11:50:00,13,5476.5,9,4,4,4,12,High-Value
16993,2010-09-02 12:16:00,2,1950.95,462,1,2,3,6,At-Risk
16996,2011-11-09 16:43:00,9,2123.61,29,3,4,3,10,High-Value
16997,2011-02-24 17:28:00,3,702.0,287,2,3,2,7,Other
16998,2011-07-13 09:44:00,5,402.0,148,2,3,2,7,Other
16999,2011-11-16 13:53:00,2,484.82,22,4,2,2,8,Other
17000,2010-11-08 13:35:00,2,406.3,395,1,2,2,5,At-Risk
17001,2011-12-09 09:38:00,19,6640.8,-1,4,4,4,12,High-Value
17002,2011-09-15 12:40:00,7,2571.55,84,3,4,4,11,High-Value
17003,2010-11-02 13:15:00,4,828.21,401,1,3,2,6,At-Risk
17004,2011-10-24 14:25:00,4,2324.36,45,3,3,4,10,High-Value
17005,2010-08-26 10:57:00,2,622.36,469,1,2,2,5,At-Risk
17006,2011-12-05 12:09:00,8,1635.27,3,4,4,3,11,High-Value
17007,2011-10-20 10:47:00,7,1120.1,49,3,4,3,10,High-Value
17008,2010-10-06 15:19:00,1,81.36,428,1,1,1,3,At-Risk
17009,2010-06-06 16:01:00,1,242.06,550,1,1,1,3,At-Risk
17010,2011-11-21 14:49:00,1,195.36,17,4,1,1,6,One-Time
17011,2011-11-09 13:30:00,3,671.7,29,3,3,2,8,Loyal
17012,2009-12-14 17:34:00,1,360.61,724,1,1,2,4,At-Risk
17014,2011-12-01 14:09:00,3,583.43,7,4,3,2,9,High-Value
17015,2011-11-11 10:45:00,3,1838.61,27,3,3,3,9,High-Value
17016,2010-05-12 12:32:00,1,552.4,575,1,1,2,4,At-Risk
17017,2011-12-07 09:32:00,29,12576.99,1,4,4,4,12,High-Value
17018,2011-10-30 11:42:00,6,2287.7,39,3,3,4,10,High-Value
17019,2011-11-28 13:06:00,11,3586.99,10,4,4,4,12,High-Value
17020,2010-06-15 13:06:00,2,935.62,541,1,2,3,6,At-Risk
17021,2010-09-23 20:01:00,6,1182.22,441,1,3,3,7,At-Risk
17022,2011-11-08 17:09:00,2,260.0,30,3,2,1,6,Other
17023,2010-10-18 15:37:00,3,800.18,416,1,3,2,6,At-Risk
17024,2011-10-25 13:47:00,3,95.85,44,3,3,1,7,Loyal
17025,2011-10-10 09:06:00,5,1349.67,59,3,3,3,9,High-Value
17026,2011-06-07 14:28:00,3,175.83,184,2,3,1,6,Other
17027,2011-09-22 12:24:00,9,1310.63,77,3,4,3,10,High-Value
17028,2010-05-07 15:33:00,3,1593.83,580,1,3,3,7,At-Risk
17029,2011-08-21 11:06:00,7,2137.3,109,2,4,3,9,High-Value
17030,2011-10-07 08:49:00,1,146.87,62,3,1,1,5,One-Time
17031,2011-11-28 10:23:00,6,2773.85,10,4,3,4,11,High-Value
17032,2010-04-15 14:14:00,5,2896.69,602,1,3,4,8,At-Risk
17033,2011-09-14 14:34:00,4,1332.79,85,3,3,3,9,High-Value
17034,2011-11-23 15:14:00,5,1276.42,15,4,3,3,10,High-Value
17035,2011-04-08 11:23:00,4,613.59,244,2,3,2,7,Other
17036,2010-11-21 14:26:00,1,176.9,382,1,1,1,3,At-Risk
17037,2011-09-13 12:49:00,1,1267.32,86,3,1,3,7,Other
17038,2011-11-09 13:50:00,2,743.17,29,3,2,2,7,Other
17039,2010-04-14 12:56:00,1,1954.99,603,1,1,3,5,At-Risk
17040,2011-07-25 10:19:00,2,463.25,136,2,2,2,6,Other
17041,2011-11-13 11:21:00,6,1655.2,25,3,3,3,9,High-Value
17042,2011-12-07 12:26:00,5,1036.58,1,4,3,3,10,High-Value
17043,2011-11-07 15:33:00,8,2593.65,31,3,4,4,11,High-Value
17044,2011-11-14 14:28:00,12,11962.3,24,4,4,4,12,High-Value
17045,2011-08-18 17:09:00,5,827.68,112,2,3,2,7,Other
17046,2011-07-05 14:24:00,5,1906.07,156,2,3,3,8,Other
17047,2011-09-15 13:27:00,6,2289.23,84,3,3,4,10,High-Value
17048,2011-08-14 11:49:00,7,2071.68,116,2,4,3,9,High-Value
17049,2011-12-07 10:48:00,19,9942.53,1,4,4,4,12,High-Value
17050,2011-09-04 13:48:00,11,4648.59,95,2,4,4,10,High-Value
17051,2011-05-29 14:13:00,4,706.49,193,2,3,2,7,Other
17052,2011-11-11 14:50:00,1,399.09,27,3,1,2,6,Other
17053,2011-08-01 10:23:00,1,498.48,129,2,1,2,5,Other
17054,2011-11-11 12:56:00,5,1356.33,27,3,3,3,9,High-Value
17055,2010-09-20 12:21:00,1,232.85,444,1,1,1,3,At-Risk
17056,2009-12-01 12:55:00,1,128.6,737,1,1,1,3,At-Risk
17057,2010-04-22 19:21:00,1,288.79,595,1,1,1,3,At-Risk
17058,2011-09-19 10:13:00,3,1179.89,80,3,3,3,9,High-Value
17059,2011-11-10 12:27:00,9,4864.57,28,3,4,4,11,High-Value
17060,2011-03-18 13:27:00,1,234.24,265,2,1,1,4,One-Time
17061,2011-09-27 11:24:00,11,5232.23,72,3,4,4,11,High-Value
17062,2011-01-30 11:01:00,6,884.71,312,2,3,3,8,Other
17063,2011-11-18 16:19:00,13,3638.53,20,4,4,4,12,High-Value
17064,2011-10-12 10:18:00,3,855.45,57,3,3,2,8,Loyal
17065,2010-03-12 11:41:00,2,194.7,636,1,2,1,4,At-Risk
17066,2009-12-13 13:24:00,1,228.34,725,1,1,1,3,At-Risk
17067,2009-12-15 08:39:00,3,454.54,723,1,3,2,6,At-Risk
17068,2011-11-27 13:14:00,47,8980.18,11,4,4,4,12,High-Value
17069,2011-11-11 17:13:00,14,5517.23,27,3,4,4,11,High-Value
17070,2011-08-17 17:01:00,2,437.42,113,2,2,2,6,Other
17071,2011-11-11 16:31:00,13,3793.71,27,3,4,4,11,High-Value
17072,2010-03-24 16:33:00,1,273.35,624,1,1,1,3,At-Risk
17073,2011-11-22 11:47:00,4,1444.84,16,4,3,3,10,High-Value
17074,2010-05-26 12:04:00,1,203.05,561,1,1,1,3,At-Risk
17075,2011-11-22 11:58:00,10,2236.63,16,4,4,3,11,High-Value
17076,2011-11-03 17:53:00,6,1242.75,35,3,3,3,9,High-Value
17077,2010-05-10 16:36:00,1,306.0,577,1,1,1,3,At-Risk
17078,2011-11-03 19:17:00,2,375.86,35,3,2,2,7,Other
17079,2011-09-22 15:34:00,1,118.8,77,3,1,1,5,One-Time
17080,2011-11-17 12:59:00,7,957.53,21,4,4,3,11,High-Value
17081,2011-11-14 12:56:00,6,949.39,24,4,3,3,10,High-Value
17082,2011-11-06 15:17:00,6,4732.03,32,3,3,4,10,High-Value
17083,2011-08-22 15:43:00,9,4049.79,108,2,4,4,10,High-Value
17084,2011-11-04 14:54:00,3,5001.21,34,3,3,4,10,High-Value
17085,2011-08-08 14:15:00,28,7839.27,122,2,4,4,10,High-Value
17086,2011-12-02 13:54:00,6,2050.08,6,4,3,3,10,High-Value
17087,2009-12-02 10:41:00,1,221.53,736,1,1,1,3,At-Risk
17088,2011-11-11 14:23:00,4,1991.01,27,3,3,3,9,High-Value
17089,2010-11-18 15:33:00,1,128.45,385,1,1,1,3,At-Risk
17090,2011-12-05 13:44:00,13,3080.18,3,4,4,4,12,High-Value
17091,2011-12-07 10:43:00,19,7495.75,1,4,4,4,12,High-Value
17092,2011-10-20 19:51:00,11,5511.41,49,3,4,4,11,High-Value
17093,2010-04-26 10:22:00,1,235.88,591,1,1,1,3,At-Risk
17094,2011-01-21 13:09:00,2,402.2,321,2,2,2,6,Other
17095,2011-11-17 12:21:00,7,2572.25,21,4,4,4,12,High-Value
17096,2011-11-24 15:01:00,11,3697.93,14,4,4,4,12,High-Value
17097,2011-12-07 17:05:00,9,1143.36,1,4,4,3,11,High-Value
17098,2010-11-23 12:13:00,3,591.07,380,1,3,2,6,At-Risk
17099,2010-06-24 16:25:00,1,582.17,532,1,1,2,4,At-Risk
17100,2011-11-21 16:36:00,2,971.74,17,4,2,3,9,High-Value
17101,2011-11-29 13:57:00,7,2507.05,9,4,4,4,12,High-Value
17102,2011-03-23 10:08:00,1,25.5,260,2,1,1,4,One-Time
17103,2009-12-17 14:08:00,1,424.3,721,1,1,2,4,At-Risk
17104,2010-10-12 12:21:00,1,474.03,422,1,1,2,4,At-Risk
17105,2011-07-03 15:53:00,2,665.78,158,2,2,2,6,Other
17106,2010-11-15 14:11:00,1,481.58,388,1,1,2,4,At-Risk
17107,2011-11-06 14:14:00,10,16052.72,32,3,4,4,11,High-Value
17108,2010-02-14 12:22:00,1,174.95,662,1,1,1,3,At-Risk
17109,2011-11-10 16:59:00,8,1291.71,28,3,4,3,10,High-Value
17110,2011-06-27 12:58:00,3,499.9,164,2,3,2,7,Other
17111,2011-10-23 15:59:00,2,459.58,46,3,2,2,7,Other
17112,2010-07-25 11:14:00,1,197.57,501,1,1,1,3,At-Risk
17113,2010-05-14 13:59:00,6,2305.59,573,1,3,4,8,At-Risk
17114,2011-12-04 12:17:00,8,801.12,4,4,4,2,10,High-Value
17115,2011-12-01 14:30:00,7,2761.49,7,4,4,4,12,High-Value
17116,2010-03-01 16:29:00,1,389.78,647,1,1,2,4,At-Risk
17117,2011-02-24 13:54:00,1,116.2,287,2,1,1,4,One-Time
17118,2011-01-26 12:19:00,1,157.02,316,2,1,1,4,One-Time
17119,2011-12-06 14:40:00,2,606.91,2,4,2,2,8,Other
17120,2011-04-20 15:21:00,1,307.46,232,2,1,1,4,One-Time
17121,2010-11-02 11:47:00,1,314.74,401,1,1,1,3,At-Risk
17122,2011-08-12 14:33:00,4,570.5,118,2,3,2,7,Other
17123,2011-07-01 10:47:00,3,966.67,160,2,3,3,8,Other
17124,2011-06-07 14:02:00,1,294.24,184,2,1,1,4,One-Time
17125,2011-10-20 14:41:00,1,230.5,49,3,1,1,5,One-Time
17126,2011-07-10 13:52:00,9,2008.93,151,2,4,3,9,High-Value
17127,2010-10-07 09:54:00,5,1155.03,427,1,3,3,7,At-Risk
17128,2011-01-09 12:02:00,1,157.09,333,2,1,1,4,One-Time
17129,2010-07-07 13:46:00,1,31.85,519,1,1,1,3,At-Risk
17131,2011-12-04 12:52:00,5,2463.17,4,4,3,4,11,High-Value
17132,2010-09-13 16:31:00,2,1220.91,451,1,2,3,6,At-Risk
17133,2011-11-24 12:27:00,12,14622.33,14,4,4,4,12,High-Value
17134,2011-08-25 09:53:00,3,625.3,105,2,3,2,7,Other
17135,2011-11-23 16:48:00,10,1716.38,15,4,4,3,11,High-Value
17136,2010-02-15 13:13:00,1,231.68,661,1,1,1,3,At-Risk
17137,2010-10-19 14:51:00,6,1099.81,415,1,3,3,7,At-Risk
17138,2011-03-09 11:54:00,7,4417.27,274,2,4,4,10,High-Value
17139,2011-11-24 10:12:00,25,19566.76,14,4,4,4,12,High-Value
17140,2011-04-06 13:33:00,1,454.12,246,2,1,2,5,Other
17141,2010-10-17 14:54:00,4,727.58,417,1,3,2,6,At-Risk
17142,2011-04-14 18:22:00,4,1275.25,238,2,3,3,8,Other
17143,2010-10-18 15:27:00,2,880.97,416,1,2,3,6,At-Risk
17144,2011-12-08 17:57:00,2,984.57,0,4,2,3,9,High-Value
17145,2010-07-15 09:02:00,4,3120.91,511,1,3,4,8,At-Risk
17146,2011-08-26 12:44:00,13,5852.64,104,2,4,4,10,High-Value
17147,2011-11-17 12:32:00,9,3199.95,21,4,4,4,12,High-Value
17148,2011-10-19 09:59:00,1,124.88,50,3,1,1,5,One-Time
17149,2010-09-14 14:56:00,1,143.1,450,1,1,1,3,At-Risk
17150,2010-11-28 11:27:00,6,1357.95,375,2,3,3,8,Other
17151,2009-12-04 14:56:00,1,231.9,734,1,1,1,3,At-Risk
17152,2011-05-29 12:19:00,4,2016.5,193,2,3,3,8,Other
17153,2011-11-15 13:42:00,1,213.78,23,4,1,1,6,One-Time
17154,2011-09-25 13:42:00,1,329.34,74,3,1,1,5,One-Time
17155,2011-11-22 12:38:00,7,892.46,16,4,4,3,11,High-Value
17156,2010-08-05 11:30:00,1,591.87,490,1,1,2,4,At-Risk
17157,2011-12-02 09:10:00,19,5151.9,6,4,4,4,12,High-Value
17158,2011-11-07 15:15:00,5,1980.0,31,3,3,3,9,High-Value
17159,2011-11-18 10:52:00,5,2099.59,20,4,3,3,10,High-Value
17160,2011-11-08 14:05:00,17,10209.16,30,3,4,4,11,High-Value
17161,2010-09-21 16:44:00,1,856.01,443,1,1,2,4,At-Risk
17162,2011-11-11 11:34:00,10,1715.46,27,3,4,3,10,High-Value
17163,2011-11-18 08:57:00,4,699.78,20,4,3,2,9,High-Value
17164,2011-11-07 09:14:00,7,2467.35,31,3,4,4,11,High-Value
17165,2011-02-28 16:39:00,6,1794.32,283,2,3,3,8,Other
17166,2011-11-01 09:46:00,2,206.34,37,3,2,1,6,Other
17167,2010-11-25 10:05:00,3,867.11,378,2,3,3,8,Other
17168,2010-07-29 12:33:00,1,400.2,497,1,1,2,4,At-Risk
17169,2011-10-13 10:25:00,3,1156.73,56,3,3,3,9,High-Value
17170,2010-11-30 15:55:00,2,178.68,373,2,2,1,5,Other
17171,2011-02-23 16:37:00,2,384.59,288,2,2,2,6,Other
17172,2011-09-22 09:36:00,3,956.57,77,3,3,3,9,High-Value
17173,2011-12-04 14:40:00,8,3766.6,4,4,4,4,12,High-Value
17174,2011-05-06 11:47:00,1,59.9,216,2,1,1,4,One-Time
17175,2011-10-26 15:31:00,4,1443.69,43,3,3,3,9,High-Value
17176,2011-05-22 12:41:00,3,902.32,200,2,3,3,8,Other
17177,2010-07-22 14:53:00,1,119.5,504,1,1,1,3,At-Risk
17178,2009-12-08 16:20:00,1,432.96,730,1,1,2,4,At-Risk
17179,2011-06-14 16:48:00,6,1507.26,177,2,3,3,8,Other
17180,2011-10-14 15:46:00,11,2236.77,55,3,4,3,10,High-Value
17181,2011-10-13 14:48:00,3,309.85,56,3,3,1,7,Loyal
17182,2010-10-13 10:09:00,2,321.3,421,1,2,1,4,At-Risk
17183,2011-12-02 10:07:00,6,3347.31,6,4,3,4,11,High-Value
17184,2010-05-19 14:24:00,2,198.41,568,1,2,1,4,At-Risk
17185,2010-04-27 12:15:00,3,229.46,590,1,3,1,5,At-Risk
17186,2011-10-24 10:20:00,2,144.0,45,3,2,1,6,Other
17187,2011-04-27 12:39:00,2,467.71,225,2,2,2,6,Other
17188,2011-11-28 13:53:00,13,4592.93,10,4,4,4,12,High-Value
17189,2011-08-25 19:39:00,5,953.63,105,2,3,3,8,Other
17190,2011-10-12 11:33:00,7,1724.73,57,3,4,3,10,High-Value
17191,2011-11-11 16:58:00,15,4310.34,27,3,4,4,11,High-Value
17192,2010-06-21 16:07:00,1,75.28,535,1,1,1,3,At-Risk
17193,2011-11-04 12:47:00,9,2310.04,34,3,4,4,11,High-Value
17194,2010-12-14 12:06:00,2,776.66,359,2,2,2,6,Other
17195,2010-02-22 13:05:00,1,562.98,654,1,1,2,4,At-Risk
17196,2010-10-08 11:31:00,1,327.75,426,1,1,1,3,At-Risk
17197,2011-11-10 10:32:00,1,1013.01,28,3,1,3,7,Other
17198,2011-11-16 10:39:00,3,692.22,22,4,3,2,9,High-Value
17199,2010-05-06 13:53:00,1,135.04,581,1,1,1,3,At-Risk
17200,2010-11-17 13:04:00,4,356.71,386,1,3,2,6,At-Risk
17201,2011-10-17 11:55:00,4,1132.6,52,3,3,3,9,High-Value
17202,2010-10-15 11:25:00,1,160.65,419,1,1,1,3,At-Risk
17203,2011-11-04 12:27:00,10,5564.09,34,3,4,4,11,High-Value
17204,2011-06-17 14:46:00,9,5504.69,174,2,4,4,10,High-Value
17205,2011-10-17 12:46:00,3,999.35,52,3,3,3,9,High-Value
17206,2011-10-17 13:25:00,1,204.24,52,3,1,1,5,One-Time
17207,2010-02-25 19:08:00,1,291.77,651,1,1,1,3,At-Risk
17208,2010-11-09 12:50:00,1,111.15,394,1,1,1,3,At-Risk
17209,2010-02-28 16:01:00,3,595.7,648,1,3,2,6,At-Risk
17210,2010-11-12 12:15:00,1,251.72,391,1,1,1,3,At-Risk
17211,2011-11-13 12:03:00,13,3773.35,25,3,4,4,11,High-Value
17212,2011-03-31 19:42:00,3,794.41,252,2,3,2,7,Other
17213,2011-10-30 14:53:00,13,4869.4,39,3,4,4,11,High-Value
17214,2011-10-10 13:17:00,6,1059.12,59,3,3,3,9,High-Value
17215,2010-09-01 13:39:00,1,186.15,463,1,1,1,3,At-Risk
17216,2010-06-03 13:03:00,1,63.6,553,1,1,1,3,At-Risk
17217,2011-04-19 17:19:00,2,210.1,233,2,2,1,5,Other
17218,2011-12-05 13:52:00,18,3889.39,3,4,4,4,12,High-Value
17219,2011-11-08 11:25:00,2,259.13,30,3,2,1,6,Other
17220,2011-11-15 13:47:00,21,4451.41,23,4,4,4,12,High-Value
17221,2011-12-02 13:35:00,5,976.62,6,4,3,3,10,High-Value
17222,2011-10-05 13:58:00,6,1563.61,64,3,3,3,9,High-Value
17223,2011-02-02 15:57:00,3,523.04,309,2,3,2,7,Other
17224,2010-07-26 13:30:00,1,100.86,500,1,1,1,3,At-Risk
17225,2010-05-07 11:38:00,1,131.15,580,1,1,1,3,At-Risk
17226,2011-02-04 11:52:00,3,895.47,307,2,3,3,8,Other
17227,2011-11-21 10:51:00,12,1878.93,17,4,4,3,11,High-Value
17228,2011-11-24 10:24:00,13,2820.03,14,4,4,4,12,High-Value
17229,2011-09-04 13:56:00,2,318.76,95,2,2,1,5,Other
17230,2011-03-20 16:12:00,18,9388.49,263,2,4,4,10,High-Value
17231,2011-11-27 15:18:00,25,7064.8,11,4,4,4,12,High-Value
17232,2011-12-07 12:21:00,2,417.77,1,4,2,2,8,Other
17233,2011-11-04 14:06:00,3,560.86,34,3,3,2,8,Loyal
17234,2011-06-10 11:20:00,1,149.89,181,2,1,1,4,One-Time
17235,2011-11-14 15:51:00,8,1562.98,24,4,4,3,11,High-Value
17236,2011-11-27 12:00:00,12,1929.26,11,4,4,3,11,High-Value
17237,2011-11-28 15:02:00,4,994.13,10,4,3,3,10,High-Value
17238,2011-12-07 11:35:00,32,7331.17,1,4,4,4,12,High-Value
17239,2011-01-31 09:41:00,4,1189.45,311,2,3,3,8,Other
17240,2010-04-22 15:44:00,1,130.6,595,1,1,1,3,At-Risk
17241,2010-11-19 13:01:00,12,2736.64,384,1,4,4,9,High-Value
17242,2011-08-23 14:55:00,5,2889.28,107,2,3,4,9,High-Value
17243,2011-12-08 13:26:00,69,20184.68,0,4,4,4,12,High-Value
17244,2011-10-17 15:19:00,5,1826.04,52,3,3,3,9,High-Value
17245,2011-05-19 10:43:00,2,371.63,203,2,2,2,6,Other
17246,2010-06-11 12:36:00,2,38.92,545,1,2,1,4,At-Risk
17247,2011-11-24 15:21:00,1,280.09,14,4,1,1,6,One-Time
17248,2011-08-11 13:34:00,2,500.54,119,2,2,2,6,Other
17249,2010-10-07 11:33:00,1,68.03,427,1,1,1,3,At-Risk
17250,2011-12-06 12:15:00,2,381.97,2,4,2,2,8,Other
17251,2010-12-12 11:06:00,3,798.98,361,2,3,2,7,Other
17252,2011-08-15 09:45:00,2,348.91,115,2,2,2,6,Other
17253,2011-11-21 12:59:00,1,178.26,17,4,1,1,6,One-Time
17254,2011-12-05 12:46:00,3,469.48,3,4,3,2,9,High-Value
17255,2011-10-30 12:18:00,4,781.7,39,3,3,2,8,Loyal
17256,2011-08-24 13:30:00,5,498.93,106,2,3,2,7,Other
17257,2010-09-29 12:51:00,2,189.78,435,1,2,1,4,At-Risk
17258,2010-11-08 12:37:00,2,417.3,395,1,2,2,5,At-Risk
17259,2011-07-14 15:01:00,6,1452.39,147,2,3,3,8,Other
17260,2010-10-24 13:21:00,1,120.95,410,1,1,1,3,At-Risk
17261,2010-07-18 11:49:00,1,221.59,508,1,1,1,3,At-Risk
17262,2011-10-18 12:56:00,11,2488.76,51,3,4,4,11,High-Value
17263,2011-05-15 14:32:00,1,63.44,207,2,1,1,4,One-Time
17264,2010-10-11 12:52:00,1,268.28,423,1,1,1,3,At-Risk
17265,2011-07-24 10:49:00,2,550.01,137,2,2,2,6,Other
17266,2011-12-07 14:12:00,5,501.72,1,4,3,2,9,High-Value
17267,2011-08-04 17:22:00,2,317.2,126,2,2,1,5,Other
17268,2011-08-24 10:06:00,11,1733.89,106,2,4,3,9,High-Value
17269,2010-11-19 11:12:00,1,491.81,384,1,1,2,4,At-Risk
17270,2010-08-27 14:09:00,2,601.45,468,1,2,2,5,At-Risk
17271,2009-12-03 13:49:00,1,204.3,735,1,1,1,3,At-Risk
17272,2011-10-28 16:37:00,4,2148.63,41,3,3,3,9,High-Value
17273,2010-10-11 15:57:00,1,141.12,423,1,1,1,3,At-Risk
17274,2011-11-04 13:16:00,2,573.22,34,3,2,2,7,Other
17275,2010-11-21 13:26:00,1,114.1,382,1,1,1,3,At-Risk
17276,2010-11-02 16:20:00,1,501.24,401,1,1,2,4,At-Risk
17277,2011-04-26 12:47:00,2,1065.35,226,2,2,3,7,Other
17278,2011-04-12 13:10:00,2,271.24,240,2,2,1,5,Other
17279,2011-10-13 11:58:00,1,187.83,56,3,1,1,5,One-Time
17280,2010-09-27 16:46:00,1,118.86,437,1,1,1,3,At-Risk
17281,2010-11-30 18:05:00,6,797.85,373,2,3,2,7,Other
17282,2011-08-01 14:29:00,5,2308.54,129,2,3,4,9,High-Value
17283,2010-11-26 11:53:00,1,188.46,377,2,1,1,4,One-Time
17284,2011-10-10 14:38:00,7,2558.6,59,3,4,4,11,High-Value
17285,2010-03-21 13:38:00,2,400.44,627,1,2,2,5,At-Risk
17286,2011-11-18 12:47:00,3,389.18,20,4,3,2,9,High-Value
17287,2011-11-13 13:27:00,21,3826.86,25,3,4,4,11,High-Value
17288,2011-11-30 16:09:00,11,2468.43,8,4,4,4,12,High-Value
17289,2011-11-08 12:01:00,9,2041.8,30,3,4,3,10,High-Value
17290,2011-12-06 12:38:00,8,1427.48,2,4,4,3,11,High-Value
17291,2011-02-04 13:04:00,1,550.8,307,2,1,2,5,Other
17292,2010-08-24 17:14:00,2,271.75,471,1,2,1,4,At-Risk
17293,2011-12-01 14:37:00,17,3750.63,7,4,4,4,12,High-Value
17294,2010-02-08 16:12:00,2,467.79,668,1,2,2,5,At-Risk
17295,2011-11-11 10:49:00,3,547.0,27,3,3,2,8,Loyal
17296,2009-12-09 14:01:00,1,338.13,729,1,1,1,3,At-Risk
17297,2011-11-22 14:43:00,1,128.18,16,4,1,1,6,One-Time
17298,2011-08-30 16:43:00,5,938.36,100,2,3,3,8,Other
17299,2011-11-28 12:01:00,6,993.23,10,4,3,3,10,High-Value
17300,2010-11-14 10:56:00,2,393.64,389,1,2,2,5,At-Risk
17301,2011-11-18 13:43:00,2,294.39,20,4,2,1,7,Other
17302,2011-11-25 09:36:00,5,1135.63,13,4,3,3,10,High-Value
17303,2010-12-13 13:32:00,1,250.04,360,2,1,1,4,One-Time
17304,2010-06-23 16:23:00,1,111.5,533,1,1,1,3,At-Risk
17305,2010-03-01 12:47:00,1,2135.46,647,1,1,3,5,At-Risk
17306,2011-11-29 12:14:00,21,9782.35,9,4,4,4,12,High-Value
17307,2010-11-09 13:40:00,11,3999.89,394,1,4,4,9,High-Value
17308,2010-11-11 13:19:00,2,4511.76,392,1,2,4,7,At-Risk
17309,2011-09-05 15:20:00,3,320.39,94,3,3,1,7,Loyal
17310,2010-11-17 16:00:00,2,1025.1,386,1,2,3,6,At-Risk
17311,2011-09-22 14:11:00,6,3566.56,77,3,3,4,10,High-Value
17312,2011-07-24 11:52:00,3,644.3,137,2,3,2,7,Other
17313,2011-11-08 15:45:00,1,2328.84,30,3,1,4,8,Other
17314,2011-11-15 09:41:00,17,4904.43,23,4,4,4,12,High-Value
17315,2011-12-08 12:15:00,41,9559.5,0,4,4,4,12,High-Value
17316,2010-10-15 14:35:00,1,124.45,419,1,1,1,3,At-Risk
17317,2011-10-24 17:19:00,3,2600.34,45,3,3,4,10,High-Value
17318,2009-12-14 13:11:00,1,157.33,724,1,1,1,3,At-Risk
17319,2010-02-08 15:47:00,1,29.1,668,1,1,1,3,At-Risk
17320,2011-08-31 13:31:00,6,2444.85,99,2,3,4,9,High-Value
17321,2011-12-01 13:41:00,6,1665.21,7,4,3,3,10,High-Value
17322,2010-11-28 14:41:00,5,922.59,375,2,3,3,8,Other
17323,2011-11-24 17:29:00,12,1547.64,14,4,4,3,11,High-Value
17324,2011-11-22 10:34:00,12,2171.07,16,4,4,3,11,High-Value
17325,2011-03-04 13:09:00,3,609.57,279,2,3,2,7,Other
17326,2010-10-27 15:38:00,2,312.35,407,1,2,1,4,At-Risk
17327,2010-10-26 09:54:00,2,152.35,408,1,2,1,4,At-Risk
17328,2010-02-04 17:11:00,1,104.7,672,1,1,1,3,At-Risk
17329,2011-11-25 14:24:00,5,998.53,13,4,3,3,10,High-Value
17330,2011-11-17 08:56:00,4,423.8,21,4,3,2,9,High-Value
17331,2011-08-08 11:55:00,1,175.2,122,2,1,1,4,One-Time
17332,2010-06-29 16:10:00,5,827.77,527,1,3,2,6,At-Risk
17333,2011-09-15 10:11:00,1,494.25,84,3,1,2,6,Other
17334,2011-02-10 14:59:00,3,635.15,301,2,3,2,7,Other
17335,2010-11-21 10:17:00,2,497.04,382,1,2,2,5,At-Risk
17336,2010-08-24 15:37:00,1,81.12,471,1,1,1,3,At-Risk
17337,2011-07-11 14:55:00,4,1979.61,150,2,3,3,8,Other
17338,2011-11-22 14:23:00,17,11880.54,16,4,4,4,12,High-Value
17339,2011-09-06 13:29:00,3,302.36,93,3,3,1,7,Loyal
17340,2011-11-10 10:45:00,18,19617.95,28,3,4,4,11,High-Value
17341,2011-07-06 12:33:00,5,1272.21,155,2,3,3,8,Other
17342,2010-11-25 11:07:00,4,1227.54,378,2,3,3,8,Other
17343,2010-12-19 15:07:00,6,1259.94,354,2,3,3,8,Other
17344,2011-10-24 12:56:00,2,457.36,45,3,2,2,7,Other
17345,2011-11-24 15:02:00,10,1586.63,14,4,4,3,11,High-Value
17346,2011-12-06 12:18:00,26,4991.41,2,4,4,4,12,High-Value
17347,2011-09-14 13:12:00,1,228.96,85,3,1,1,5,One-Time
17348,2011-11-25 11:25:00,9,2430.99,13,4,4,4,12,High-Value
17349,2011-06-13 14:29:00,5,772.41,178,2,3,2,7,Other
17350,2011-12-01 15:47:00,7,1893.7,7,4,4,3,11,High-Value
17351,2011-11-03 18:45:00,12,1964.38,35,3,4,3,10,High-Value
17352,2010-01-12 16:13:00,1,36.25,695,1,1,1,3,At-Risk
17353,2011-08-02 17:19:00,4,3242.0,128,2,3,4,9,High-Value
17354,2011-10-20 10:34:00,4,3133.96,49,3,3,4,10,High-Value
17355,2010-11-18 13:18:00,1,273.31,385,1,1,1,3,At-Risk
17356,2011-02-01 11:07:00,5,946.47,310,2,3,3,8,Other
17357,2011-11-15 16:30:00,2,384.39,23,4,2,2,8,Other
17358,2011-02-09 16:57:00,5,861.01,302,2,3,3,8,Other
17359,2011-11-28 14:37:00,2,284.46,10,4,2,1,7,Other
17360,2011-11-22 13:11:00,6,1200.51,16,4,3,3,10,High-Value
17361,2011-10-21 15:43:00,5,871.79,48,3,3,3,9,High-Value
17362,2011-04-14 14:43:00,7,1024.04,238,2,4,3,9,High-Value
17363,2010-11-09 17:11:00,3,920.46,394,1,3,3,7,At-Risk
17364,2011-12-09 09:00:00,28,11972.92,-1,4,4,4,12,High-Value
17365,2011-11-27 12:13:00,15,8179.45,11,4,4,4,12,High-Value
17366,2010-10-03 16:04:00,2,1077.24,431,1,2,3,6,At-Risk
17367,2011-04-15 14:21:00,1,167.55,237,2,1,1,4,One-Time
17368,2011-11-16 15:26:00,14,2758.29,22,4,4,4,12,High-Value
17369,2010-09-10 09:49:00,1,979.2,454,1,1,3,5,At-Risk
17370,2011-09-28 10:14:00,4,446.18,71,3,3,2,8,Loyal
17371,2011-11-22 13:30:00,6,651.37,16,4,3,2,9,High-Value
17372,2011-10-30 11:37:00,27,4316.46,39,3,4,4,11,High-Value
17373,2011-10-30 15:28:00,7,1167.5,39,3,4,3,10,High-Value
17374,2011-05-05 09:05:00,3,727.11,217,2,3,2,7,Other
17375,2011-05-24 15:45:00,4,660.55,198,2,3,2,7,Other
17376,2011-09-30 12:36:00,4,453.64,69,3,3,2,8,Loyal
17377,2011-11-16 11:17:00,78,17639.23,22,4,4,4,12,High-Value
17378,2010-11-30 18:46:00,1,10.95,373,2,1,1,4,One-Time
17379,2011-11-28 13:56:00,1,389.72,10,4,1,2,7,Other
17380,2010-10-01 16:42:00,3,645.0,433,1,3,2,6,At-Risk
17381,2011-12-01 11:59:00,38,36398.65,7,4,4,4,12,High-Value
17382,2011-10-05 13:05:00,8,902.28,64,3,4,3,10,High-Value
17383,2011-12-05 17:36:00,2,304.09,3,4,2,1,7,Other
17384,2011-11-20 15:48:00,3,507.55,18,4,3,2,9,High-Value
17385,2011-11-25 11:02:00,1,256.11,13,4,1,1,6,One-Time
17386,2011-12-02 11:28:00,7,2812.77,6,4,4,4,12,High-Value
17387,2011-11-20 11:00:00,2,746.81,18,4,2,2,8,Other
17388,2011-09-23 10:31:00,11,2675.37,76,3,4,4,11,High-Value
17389,2011-12-09 09:38:00,61,57215.33,-1,4,4,4,12,High-Value
17390,2010-10-15 11:29:00,1,149.3,419,1,1,1,3,At-Risk
17391,2011-06-29 09:58:00,2,508.8,162,2,2,2,6,Other
17392,2011-02-06 12:48:00,3,579.92,305,2,3,2,7,Other
17393,2010-10-25 11:10:00,2,381.15,409,1,2,2,5,At-Risk
17394,2011-05-04 13:22:00,1,203.87,218,2,1,1,4,One-Time
17395,2010-07-19 15:34:00,1,97.5,507,1,1,1,3,At-Risk
17396,2011-10-31 14:12:00,13,8391.6,38,3,4,4,11,High-Value
17397,2011-11-17 14:08:00,3,1198.28,21,4,3,3,10,High-Value
17398,2011-08-17 09:48:00,3,653.38,113,2,3,2,7,Other
17400,2011-08-05 15:38:00,8,4623.28,125,2,4,4,10,High-Value
17401,2010-06-16 16:54:00,1,114.85,540,1,1,1,3,At-Risk
17402,2011-12-05 10:15:00,22,4600.56,3,4,4,4,12,High-Value
17403,2011-11-03 15:18:00,2,382.87,35,3,2,2,7,Other
17404,2011-12-05 16:26:00,21,47638.12,3,4,4,4,12,High-Value
17405,2011-12-08 17:12:00,3,1031.41,0,4,3,3,10,High-Value
17406,2011-01-10 15:07:00,13,4186.95,332,2,4,4,10,High-Value
17407,2010-10-24 11:57:00,1,552.9,410,1,1,2,4,At-Risk
17408,2011-06-29 12:53:00,3,316.09,162,2,3,1,6,Other
17409,2011-06-08 10:36:00,10,7793.51,183,2,4,4,10,High-Value
17410,2011-11-23 15:46:00,5,1214.72,15,4,3,3,10,High-Value
17411,2011-11-27 14:25:00,5,1425.38,11,4,3,3,10,High-Value
17412,2011-12-07 11:36:00,16,4220.22,1,4,4,4,12,High-Value
17413,2010-10-31 12:33:00,2,560.14,403,1,2,2,5,At-Risk
17414,2011-10-27 12:13:00,6,2249.52,42,3,3,4,10,High-Value
17415,2011-09-21 12:50:00,1,507.84,78,3,1,2,6,Other
17416,2011-11-10 12:47:00,22,17298.45,28,3,4,4,11,High-Value
17417,2010-06-09 10:00:00,1,164.18,547,1,1,1,3,At-Risk
17418,2011-10-28 13:00:00,3,670.06,41,3,3,2,8,Loyal
17419,2011-11-28 13:47:00,18,6126.25,10,4,4,4,12,High-Value
17420,2011-10-20 14:52:00,6,953.58,49,3,3,3,9,High-Value
17421,2010-11-18 16:57:00,3,1059.41,385,1,3,3,7,At-Risk
17422,2011-11-23 13:27:00,11,3594.76,15,4,4,4,12,High-Value
17423,2011-10-24 13:36:00,3,1118.95,45,3,3,3,9,High-Value
17425,2011-11-20 15:30:00,2,759.17,18,4,2,2,8,Other
17426,2011-12-01 18:07:00,13,8077.77,7,4,4,4,12,High-Value
17427,2011-09-29 11:29:00,1,100.8,70,3,1,1,5,One-Time
17428,2011-12-09 09:45:00,45,31466.76,-1,4,4,4,12,High-Value
17429,2011-08-03 13:22:00,5,1357.46,127,2,3,3,8,Other
17430,2011-11-07 09:24:00,4,622.57,31,3,3,2,8,Loyal
17431,2011-01-30 14:36:00,1,403.3,312,2,1,2,5,Other
17432,2011-11-21 17:33:00,9,1728.99,17,4,4,3,11,High-Value
17433,2011-09-12 14:24:00,2,569.96,87,3,2,2,7,Other
17434,2011-12-07 13:16:00,7,2373.82,1,4,4,4,12,High-Value
17435,2010-10-24 13:55:00,1,331.35,410,1,1,1,3,At-Risk
17436,2011-12-08 12:30:00,5,534.06,0,4,3,2,9,High-Value
17437,2010-06-28 11:11:00,1,369.68,528,1,1,2,4,At-Risk
17438,2011-03-31 10:26:00,5,1422.77,252,2,3,3,8,Other
17439,2010-02-22 12:48:00,1,325.74,654,1,1,1,3,At-Risk
17440,2011-07-06 11:54:00,4,323.58,155,2,3,1,6,Other
17441,2009-12-07 13:32:00,1,293.35,731,1,1,1,3,At-Risk
17442,2011-11-03 09:17:00,15,4620.3,35,3,4,4,11,High-Value
17443,2011-05-04 10:47:00,1,534.24,218,2,1,2,5,Other
17444,2011-07-11 10:33:00,2,2389.1,150,2,2,4,8,Other
17446,2011-06-16 10:42:00,2,120.9,175,2,2,1,5,Other
17447,2011-10-30 14:18:00,2,541.53,39,3,2,2,7,Other
17448,2010-06-28 13:58:00,41,14448.67,528,1,4,4,9,High-Value
17449,2011-12-07 16:56:00,13,4865.15,1,4,4,4,12,High-Value
17450,2011-12-01 13:29:00,51,244784.25,7,4,4,4,12,High-Value
17451,2011-12-08 15:02:00,7,1721.4,0,4,4,3,11,High-Value
17453,2011-11-22 09:42:00,2,486.72,16,4,2,2,8,Other
17454,2011-05-31 13:58:00,10,1547.94,191,2,4,3,9,High-Value
17455,2011-05-20 12:31:00,1,131.7,202,2,1,1,4,One-Time
17456,2010-12-09 15:23:00,2,975.56,364,2,2,3,7,Other
17457,2011-08-05 12:48:00,14,5984.81,125,2,4,4,10,High-Value
17458,2011-11-24 13:01:00,2,529.58,14,4,2,2,8,Other
17459,2011-10-27 13:25:00,2,657.3,42,3,2,2,7,Other
17460,2011-09-06 15:04:00,16,2157.97,93,3,4,3,10,High-Value
17461,2011-11-17 10:21:00,3,735.82,21,4,3,2,9,High-Value
17462,2011-10-10 13:56:00,2,675.69,59,3,2,2,7,Other
17463,2011-11-23 13:40:00,7,2535.26,15,4,4,4,12,High-Value
17464,2011-07-04 13:19:00,3,907.14,157,2,3,3,8,Other
17465,2010-10-10 11:56:00,7,2542.79,424,1,4,4,9,High-Value
17466,2011-11-29 13:15:00,2,763.28,9,4,2,2,8,Other
17467,2010-11-09 12:58:00,1,102.6,394,1,1,1,3,At-Risk
17468,2011-11-29 15:33:00,3,194.8,9,4,3,1,8,Loyal
17469,2011-11-23 13:15:00,17,5051.25,15,4,4,4,12,High-Value
17470,2011-10-26 12:42:00,11,2626.47,43,3,4,4,11,High-Value
17471,2010-08-22 11:53:00,1,321.65,473,1,1,1,3,At-Risk
17472,2011-06-01 14:57:00,4,922.35,190,2,3,3,8,Other
17473,2010-10-27 11:45:00,2,607.0,407,1,2,2,5,At-Risk
17474,2010-04-19 10:43:00,1,1047.0,598,1,1,3,5,At-Risk
17475,2011-09-21 14:55:00,1,194.37,78,3,1,1,5,One-Time
17476,2010-11-09 10:21:00,2,489.86,394,1,2,2,5,At-Risk
17477,2010-04-06 10:06:00,2,1144.3,611,1,2,3,6,At-Risk
17478,2010-10-27 15:01:00,2,1272.8,407,1,2,3,6,At-Risk
17479,2010-03-17 09:26:00,1,389.26,631,1,1,2,4,At-Risk
17480,2011-09-23 11:39:00,2,882.23,76,3,2,3,8,Other
17481,2011-12-06 12:28:00,4,1255.59,2,4,3,3,10,High-Value
17482,2010-08-09 15:33:00,2,775.64,486,1,2,2,5,At-Risk
17483,2011-10-05 13:10:00,4,591.73,64,3,3,2,8,Loyal
17484,2010-05-12 15:41:00,2,209.57,575,1,2,1,4,At-Risk
17486,2011-03-23 14:00:00,1,396.87,260,2,1,2,5,Other
17487,2009-12-11 15:06:00,1,160.55,727,1,1,1,3,At-Risk
17488,2010-03-08 14:07:00,1,336.5,640,1,1,1,3,At-Risk
17489,2011-10-12 08:56:00,2,376.64,57,3,2,2,7,Other
17490,2011-12-09 09:08:00,9,2750.5,-1,4,4,4,12,High-Value
17491,2011-12-08 16:18:00,17,5653.67,0,4,4,4,12,High-Value
17492,2011-04-05 15:21:00,3,1122.42,247,2,3,3,8,Other
17493,2010-11-19 16:57:00,1,100.91,384,1,1,1,3,At-Risk
17494,2010-07-26 10:06:00,1,54.7,500,1,1,1,3,At-Risk
17495,2011-12-02 12:08:00,3,806.72,6,4,3,2,9,High-Value
17496,2010-12-16 08:39:00,4,1412.89,357,2,3,3,8,Other
17497,2010-11-14 14:17:00,2,287.25,389,1,2,1,4,At-Risk
17498,2011-09-25 12:25:00,1,272.22,74,3,1,1,5,One-Time
17499,2011-02-23 09:14:00,2,1341.39,288,2,2,3,7,Other
17500,2011-11-22 14:25:00,3,1138.0,16,4,3,3,10,High-Value
17501,2011-05-03 09:47:00,2,288.6,219,2,2,1,5,Other
17502,2011-11-30 13:13:00,4,689.1,8,4,3,2,9,High-Value
17503,2011-12-07 09:18:00,2,558.96,1,4,2,2,8,Other
17504,2011-05-17 12:59:00,18,9490.17,205,2,4,4,10,High-Value
17505,2011-07-01 12:50:00,5,2435.48,160,2,3,4,9,High-Value
17506,2011-09-25 11:39:00,1,302.2,74,3,1,1,5,One-Time
17507,2011-03-23 11:48:00,2,605.58,260,2,2,2,6,Other
17508,2011-03-04 08:10:00,8,4579.23,279,2,4,4,10,High-Value
17509,2011-10-13 10:26:00,8,6083.64,56,3,4,4,11,High-Value
17510,2011-11-15 10:00:00,2,514.56,23,4,2,2,8,Other
17511,2011-12-07 10:12:00,60,172132.87,1,4,4,4,12,High-Value
17512,2011-11-11 12:11:00,18,5467.82,27,3,4,4,11,High-Value
17513,2011-09-28 16:42:00,3,1158.8,71,3,3,3,9,High-Value
17514,2011-08-03 15:45:00,2,522.0,127,2,2,2,6,Other
17515,2011-11-08 14:04:00,9,1602.51,30,3,4,3,10,High-Value
17516,2011-11-24 16:51:00,6,947.5,14,4,3,3,10,High-Value
17517,2011-02-04 11:48:00,1,153.94,307,2,1,1,4,One-Time
17518,2010-10-10 12:40:00,2,329.42,424,1,2,1,4,At-Risk
17519,2011-11-22 16:43:00,15,4774.17,16,4,4,4,12,High-Value
17520,2011-10-17 12:04:00,1,546.81,52,3,1,2,6,Other
17521,2011-11-10 11:22:00,5,1278.06,28,3,3,3,9,High-Value
17522,2011-12-08 12:31:00,5,1066.15,0,4,3,3,10,High-Value
17523,2011-11-28 13:20:00,4,652.74,10,4,3,2,9,High-Value
17524,2010-12-13 14:32:00,3,539.14,360,2,3,2,7,Other
17525,2010-12-15 12:05:00,3,1161.9,358,2,3,3,8,Other
17526,2011-12-05 11:05:00,12,3939.24,3,4,4,4,12,High-Value
17527,2011-10-17 12:32:00,4,939.37,52,3,3,3,9,High-Value
17528,2011-12-08 13:27:00,8,3628.5,0,4,4,4,12,High-Value
17529,2010-04-08 17:51:00,2,1240.25,609,1,2,3,6,At-Risk
17530,2011-12-08 18:42:00,12,2787.1,0,4,4,4,12,High-Value
17531,2011-06-02 19:17:00,3,1266.82,189,2,3,3,8,Other
17532,2010-11-19 08:13:00,1,65.34,384,1,1,1,3,At-Risk
17533,2010-10-01 09:14:00,1,34.8,433,1,1,1,3,At-Risk
17534,2011-10-17 12:47:00,5,1668.83,52,3,3,3,9,High-Value
17535,2011-03-04 15:20:00,1,164.4,279,2,1,1,4,One-Time
17536,2011-06-15 13:23:00,3,364.83,176,2,3,2,7,Other
17537,2011-11-10 10:56:00,2,887.67,28,3,2,3,8,Other
17538,2011-11-14 12:12:00,1,98.42,24,4,1,1,6,One-Time
17539,2010-03-21 15:23:00,3,1161.84,627,1,3,3,7,At-Risk
17540,2011-11-15 11:56:00,6,1590.6,23,4,3,3,10,High-Value
17541,2010-07-18 11:36:00,1,119.86,508,1,1,1,3,At-Risk
17542,2011-03-15 11:45:00,3,340.85,268,2,3,2,7,Other
17543,2010-06-08 12:41:00,1,120.05,548,1,1,1,3,At-Risk
17544,2010-11-14 15:08:00,3,944.82,389,1,3,3,7,At-Risk
17545,2011-10-27 14:04:00,6,1409.86,42,3,3,3,9,High-Value
17547,2010-11-29 09:41:00,2,727.85,374,2,2,2,6,Other
17548,2011-04-20 12:01:00,4,731.26,232,2,3,2,7,Other
17549,2011-11-16 09:59:00,2,148.86,22,4,2,1,7,Other
17550,2011-05-26 14:09:00,9,2506.64,196,2,4,4,10,High-Value
17551,2010-12-15 14:12:00,1,290.34,358,2,1,1,4,One-Time
17552,2011-10-10 17:00:00,12,2786.77,59,3,4,4,11,High-Value
17553,2011-08-02 10:00:00,4,3757.6,128,2,3,4,9,High-Value
17554,2011-12-08 14:15:00,5,1952.45,0,4,3,3,10,High-Value
17555,2011-11-20 12:22:00,5,1045.74,18,4,3,3,10,High-Value
17556,2011-05-18 10:48:00,2,300.67,204,2,2,1,5,Other
17557,2011-11-25 12:57:00,4,575.46,13,4,3,2,9,High-Value
17558,2010-11-11 14:36:00,1,259.17,392,1,1,1,3,At-Risk
17559,2010-07-15 12:02:00,1,167.62,511,1,1,1,3,At-Risk
17560,2011-09-06 09:18:00,8,1895.8,93,3,4,3,10,High-Value
17561,2011-11-20 12:53:00,4,703.02,18,4,3,2,9,High-Value
17562,2011-11-25 14:21:00,7,1122.38,13,4,4,3,11,High-Value
17563,2010-05-10 14:54:00,2,392.38,577,1,2,2,5,At-Risk
17564,2011-11-15 13:27:00,3,454.01,23,4,3,2,9,High-Value
17565,2010-05-02 11:54:00,1,131.83,585,1,1,1,3,At-Risk
17566,2011-12-01 19:54:00,2,869.77,7,4,2,3,9,High-Value
17567,2011-12-02 15:48:00,9,4838.08,6,4,4,4,12,High-Value
17568,2010-03-16 16:45:00,1,374.45,632,1,1,2,4,At-Risk
17569,2011-01-11 14:15:00,1,344.14,331,2,1,2,5,Other
17571,2011-10-20 15:57:00,5,1629.66,49,3,3,3,9,High-Value
17572,2011-09-29 17:53:00,10,652.21,70,3,4,2,9,High-Value
17573,2011-11-10 13:01:00,3,380.6,28,3,3,2,8,Loyal
17574,2011-04-11 09:47:00,1,185.65,241,2,1,1,4,One-Time
17575,2010-02-10 13:48:00,1,171.7,666,1,1,1,3,At-Risk
17576,2011-12-01 17:56:00,41,8705.6,7,4,4,4,12,High-Value
17577,2010-03-04 13:01:00,2,348.75,644,1,2,2,5,At-Risk
17578,2011-05-05 18:38:00,7,1047.33,217,2,4,3,9,High-Value
17579,2011-12-05 12:28:00,4,753.28,3,4,3,2,9,High-Value
17580,2011-04-01 12:41:00,5,538.07,251,2,3,2,7,Other
17581,2011-12-09 12:21:00,43,17951.17,-1,4,4,4,12,High-Value
17582,2011-04-17 13:18:00,5,1446.95,235,2,3,3,8,Other
17583,2010-05-28 14:24:00,1,135.95,559,1,1,1,3,At-Risk
17584,2011-12-02 17:12:00,6,5309.42,6,4,3,4,11,High-Value
17585,2011-08-22 13:30:00,7,2064.71,108,2,4,3,9,High-Value
17586,2010-03-30 13:12:00,1,167.4,618,1,1,1,3,At-Risk
17587,2010-03-21 14:16:00,1,173.76,627,1,1,1,3,At-Risk
17588,2011-08-31 13:37:00,7,2939.55,99,2,4,4,10,High-Value
17589,2011-10-10 16:58:00,18,13806.27,59,3,4,4,11,High-Value
17590,2011-12-07 12:55:00,3,1466.77,1,4,3,3,10,High-Value
17591,2011-09-27 13:42:00,8,2339.32,72,3,4,4,11,High-Value
17592,2009-12-01 10:49:00,1,148.3,737,1,1,1,3,At-Risk
17593,2011-12-06 10:30:00,11,8092.32,2,4,4,4,12,High-Value
17594,2011-09-15 16:34:00,4,2497.88,84,3,3,4,10,High-Value
17595,2011-11-27 16:08:00,2,386.69,11,4,2,2,8,Other
17596,2011-11-16 14:11:00,13,4491.46,22,4,4,4,12,High-Value
17597,2011-05-10 11:54:00,5,3484.09,212,2,3,4,9,High-Value
17598,2010-11-23 17:43:00,1,409.98,380,1,1,2,4,At-Risk
17599,2010-08-19 12:50:00,1,52.05,476,1,1,1,3,At-Risk
17600,2011-11-22 09:43:00,1,161.67,16,4,1,1,6,One-Time
17601,2011-04-14 18:02:00,2,412.66,238,2,2,2,6,Other
17602,2011-12-07 13:53:00,14,7354.43,1,4,4,4,12,High-Value
17603,2011-09-22 14:18:00,4,1788.38,77,3,3,3,9,High-Value
17604,2011-05-06 13:43:00,6,942.38,216,2,3,3,8,Other
17605,2010-04-28 14:45:00,1,160.75,589,1,1,1,3,At-Risk
17606,2009-12-02 13:32:00,1,87.3,736,1,1,1,3,At-Risk
17607,2010-11-28 13:11:00,1,333.81,375,2,1,1,4,One-Time
17608,2011-11-06 13:06:00,4,488.06,32,3,3,2,8,Loyal
17609,2011-10-30 12:28:00,11,1875.36,39,3,4,3,10,High-Value
17610,2010-06-17 16:34:00,5,1511.94,539,1,3,3,7,At-Risk
17611,2011-12-02 13:29:00,28,8287.53,6,4,4,4,12,High-Value
17612,2011-10-17 14:59:00,18,5394.86,52,3,4,4,11,High-Value
17613,2011-11-17 10:51:00,14,4544.55,21,4,4,4,12,High-Value
17614,2011-10-13 16:01:00,1,386.32,56,3,1,2,6,Other
17615,2011-08-01 14:06:00,6,721.8,129,2,3,2,7,Other
17616,2011-06-19 10:11:00,4,734.4,172,2,3,2,7,Other
17617,2010-05-30 12:48:00,1,385.19,557,1,1,2,4,At-Risk
17618,2011-12-04 11:50:00,11,4001.64,4,4,4,4,12,High-Value
17619,2011-01-31 14:18:00,1,214.37,311,2,1,1,4,One-Time
17620,2011-10-11 12:08:00,1,81.44,58,3,1,1,5,One-Time
17621,2011-11-18 17:11:00,6,3175.12,20,4,3,4,11,High-Value
17622,2010-04-21 12:36:00,2,1130.21,596,1,2,3,6,At-Risk
17623,2011-11-07 11:32:00,7,2365.77,31,3,4,4,11,High-Value
17624,2011-11-25 10:52:00,4,1568.63,13,4,3,3,10,High-Value
17625,2011-11-21 13:36:00,8,5978.9,17,4,4,4,12,High-Value
17626,2010-04-16 12:15:00,1,254.0,601,1,1,1,3,At-Risk
17627,2010-08-18 11:27:00,1,296.36,477,1,1,1,3,At-Risk
17628,2011-09-19 15:21:00,1,75.75,80,3,1,1,5,One-Time
17629,2011-12-04 10:56:00,10,2455.52,4,4,4,4,12,High-Value
17630,2011-06-23 11:58:00,2,503.6,168,2,2,2,6,Other
17631,2011-12-08 09:47:00,7,998.49,0,4,4,3,11,High-Value
17633,2011-11-08 13:25:00,7,2057.39,30,3,4,3,10,High-Value
17634,2011-11-03 13:09:00,9,2358.59,35,3,4,4,11,High-Value
17635,2010-10-11 15:12:00,3,1265.58,423,1,3,3,7,At-Risk
17636,2011-11-20 14:40:00,1,285.56,18,4,1,1,6,One-Time
17637,2011-11-08 12:51:00,2,547.06,30,3,2,2,7,Other
17638,2010-03-02 14:32:00,2,842.4,646,1,2,2,5,At-Risk
17639,2011-03-08 15:22:00,6,615.17,275,2,3,2,7,Other
17640,2011-09-14 09:13:00,6,3168.94,85,3,3,4,10,High-Value
17642,2011-08-12 09:11:00,5,1824.49,118,2,3,3,8,Other
17643,2010-12-01 14:38:00,2,439.7,372,2,2,2,6,Other
17644,2011-12-08 13:43:00,20,6028.6,0,4,4,4,12,High-Value
17646,2011-05-04 13:17:00,12,3898.79,218,2,4,4,10,High-Value
17647,2011-10-05 15:38:00,3,331.66,64,3,3,1,7,Loyal
17648,2011-10-10 09:41:00,5,2216.37,59,3,3,3,9,High-Value
17649,2011-07-24 15:53:00,3,1578.89,137,2,3,3,8,Other
17650,2011-11-18 14:52:00,1,166.08,20,4,1,1,6,One-Time
17651,2011-11-28 10:29:00,16,5703.52,10,4,4,4,12,High-Value
17652,2011-11-14 12:55:00,12,4867.72,24,4,4,4,12,High-Value
17653,2011-11-03 12:46:00,4,1207.56,35,3,3,3,9,High-Value
17654,2011-03-07 13:17:00,1,117.55,276,2,1,1,4,One-Time
17655,2011-11-29 11:34:00,9,2976.38,9,4,4,4,12,High-Value
17656,2011-09-27 13:04:00,5,1674.69,72,3,3,3,9,High-Value
17657,2010-10-05 14:52:00,1,126.0,429,1,1,1,3,At-Risk
17658,2011-11-14 12:07:00,2,595.42,24,4,2,2,8,Other
17659,2011-11-22 13:29:00,14,3586.99,16,4,4,4,12,High-Value
17660,2011-07-21 13:37:00,2,342.22,140,2,2,2,6,Other
17662,2010-02-16 09:38:00,2,412.92,660,1,2,2,5,At-Risk
17663,2011-11-14 08:56:00,17,5175.83,24,4,4,4,12,High-Value
17664,2011-11-21 11:29:00,4,1166.23,17,4,3,3,10,High-Value
17665,2010-08-03 13:12:00,1,563.1,492,1,1,2,4,At-Risk
17666,2011-12-06 09:06:00,5,2047.8,2,4,3,3,10,High-Value
17667,2011-10-04 14:32:00,9,3950.7,65,3,4,4,11,High-Value
17668,2011-12-08 13:25:00,2,347.75,0,4,2,2,8,Other
17669,2011-10-28 08:53:00,10,6142.35,41,3,4,4,11,High-Value
17670,2011-04-26 09:12:00,1,205.7,226,2,1,1,4,One-Time
17671,2011-11-24 12:21:00,5,2009.16,14,4,3,3,10,High-Value
17672,2011-10-20 14:18:00,6,5663.74,49,3,3,4,10,High-Value
17673,2011-12-08 12:50:00,13,4173.88,0,4,4,4,12,High-Value
17674,2011-09-26 13:35:00,2,551.04,73,3,2,2,7,Other
17675,2011-12-08 18:03:00,70,37642.48,0,4,4,4,12,High-Value
17676,2011-12-05 15:16:00,10,2448.64,3,4,4,4,12,High-Value
17677,2011-12-08 09:56:00,54,35058.46,0,4,4,4,12,High-Value
17678,2011-03-21 11:52:00,2,599.76,262,2,2,2,6,Other
17679,2011-10-18 07:43:00,7,3577.61,51,3,4,4,11,High-Value
17680,2011-11-16 12:42:00,3,497.45,22,4,3,2,9,High-Value
17681,2010-04-21 17:22:00,5,731.2,596,1,3,2,6,At-Risk
17682,2011-11-29 15:59:00,11,4065.28,9,4,4,4,12,High-Value
17683,2010-11-19 10:11:00,3,819.01,384,1,3,2,6,At-Risk
17684,2011-10-27 11:10:00,1,239.41,42,3,1,1,5,One-Time
17685,2011-11-23 11:36:00,12,5454.95,15,4,4,4,12,High-Value
17686,2011-12-02 15:39:00,9,8296.81,6,4,4,4,12,High-Value
17687,2010-10-15 12:30:00,1,432.68,419,1,1,2,4,At-Risk
17688,2010-11-11 10:41:00,1,304.2,392,1,1,1,3,At-Risk
17689,2010-11-16 13:22:00,2,317.08,387,1,2,1,4,At-Risk
17690,2011-11-09 15:17:00,20,6963.8,29,3,4,4,11,High-Value
17691,2010-12-16 17:20:00,4,637.55,357,2,3,2,7,Other
17692,2011-08-04 14:01:00,12,2960.44,126,2,4,4,10,High-Value
17693,2011-07-25 15:48:00,1,200.47,136,2,1,1,4,One-Time
17694,2011-07-21 12:00:00,3,1695.97,140,2,3,3,8,Other
17695,2011-07-31 10:40:00,5,1746.04,130,2,3,3,8,Other
17696,2011-11-01 13:43:00,27,7679.59,37,3,4,4,11,High-Value
17697,2011-04-17 15:40:00,1,338.95,235,2,1,1,4,One-Time
17698,2011-03-24 11:34:00,1,154.95,259,2,1,1,4,One-Time
17699,2010-08-20 09:39:00,2,442.0,475,1,2,2,5,At-Risk
17700,2011-11-23 11:51:00,14,6679.97,15,4,4,4,12,High-Value
17701,2011-04-01 12:25:00,1,417.95,251,2,1,2,5,Other
17702,2011-11-09 16:03:00,6,3144.04,29,3,3,4,10,High-Value
17703,2011-11-04 15:51:00,4,1094.84,34,3,3,3,9,High-Value
17704,2011-06-24 09:40:00,2,885.19,167,2,2,3,7,Other
17705,2011-12-06 13:45:00,11,2083.9,2,4,4,3,11,High-Value
17706,2011-12-05 13:34:00,31,20272.15,3,4,4,4,12,High-Value
17707,2011-06-07 15:03:00,8,609.3,184,2,4,2,8,Other
17708,2011-06-05 10:12:00,4,884.18,186,2,3,3,8,Other
17709,2011-06-23 11:55:00,5,671.01,168,2,3,2,7,Other
17710,2010-10-12 07:49:00,1,293.5,422,1,1,1,3,At-Risk
17711,2011-11-29 11:40:00,2,385.1,9,4,2,2,8,Other
17712,2011-10-26 12:28:00,1,522.91,43,3,1,2,6,Other
17713,2010-11-22 16:50:00,4,1198.09,381,1,3,3,7,At-Risk
17714,2011-01-23 10:32:00,5,1410.18,319,2,3,3,8,Other
17715,2011-05-23 12:32:00,2,489.6,199,2,2,2,6,Other
17716,2011-11-17 12:00:00,24,15956.97,21,4,4,4,12,High-Value
17717,2010-10-14 12:54:00,1,376.92,420,1,1,2,4,At-Risk
17718,2011-04-21 13:39:00,2,439.18,231,2,2,2,6,Other
17719,2011-11-02 10:36:00,15,5396.04,36,3,4,4,11,High-Value
17720,2011-11-13 15:04:00,10,2666.91,25,3,4,4,11,High-Value
17721,2010-02-18 15:18:00,1,307.21,658,1,1,1,3,At-Risk
17722,2011-09-04 15:22:00,5,3520.22,95,2,3,4,9,High-Value
17723,2011-08-04 18:37:00,7,3378.4,126,2,4,4,10,High-Value
17724,2011-09-29 15:26:00,3,1033.0,70,3,3,3,9,High-Value
17725,2011-11-23 16:34:00,11,3439.08,15,4,4,4,12,High-Value
17726,2010-11-09 13:37:00,7,1092.06,394,1,4,3,8,At-Risk
17727,2011-11-24 17:06:00,1,1060.25,14,4,1,3,8,Other
17728,2011-12-06 08:52:00,5,4238.76,2,4,3,4,11,High-Value
17729,2010-04-22 15:03:00,1,438.65,595,1,1,2,4,At-Risk
17730,2011-12-06 15:43:00,20,7773.8,2,4,4,4,12,High-Value
17731,2011-09-21 15:02:00,6,1708.99,78,3,3,3,9,High-Value
17732,2010-12-02 09:29:00,8,2166.42,371,2,4,3,9,High-Value
17733,2011-11-01 08:16:00,2,692.19,37,3,2,2,7,Other
17734,2011-10-17 12:33:00,6,1442.32,52,3,3,3,9,High-Value
17735,2011-12-07 16:47:00,26,16790.33,1,4,4,4,12,High-Value
17736,2011-11-30 15:36:00,3,377.44,8,4,3,2,9,High-Value
17737,2011-11-30 15:16:00,2,168.24,8,4,2,1,7,Other
17738,2011-11-20 15:05:00,13,4183.56,18,4,4,4,12,High-Value
17739,2011-11-28 09:12:00,18,7730.59,10,4,4,4,12,High-Value
17740,2010-11-15 16:33:00,6,426.9,388,1,3,2,6,At-Risk
17741,2010-10-29 11:59:00,2,101.1,405,1,2,1,4,At-Risk
17742,2011-08-18 15:28:00,11,2098.48,112,2,4,3,9,High-Value
17743,2010-09-17 14:54:00,1,229.2,447,1,1,1,3,At-Risk
17744,2011-12-06 12:11:00,7,2649.14,2,4,4,4,12,High-Value
17745,2010-08-19 12:30:00,2,600.34,476,1,2,2,5,At-Risk
17746,2011-04-13 14:31:00,4,904.18,239,2,3,3,8,Other
17747,2011-08-19 08:13:00,1,71.4,111,2,1,1,4,One-Time
17748,2010-06-30 13:49:00,1,358.15,526,1,1,2,4,At-Risk
17749,2011-06-14 15:45:00,3,1026.18,177,2,3,3,8,Other
17750,2011-12-04 14:09:00,9,1694.16,4,4,4,3,11,High-Value
17751,2010-10-14 13:57:00,1,157.86,420,1,1,1,3,At-Risk
17752,2010-12-15 16:19:00,1,80.64,358,2,1,1,4,One-Time
17753,2010-09-01 15:49:00,4,382.06,463,1,3,2,6,At-Risk
17754,2011-12-09 11:20:00,13,4451.22,-1,4,4,4,12,High-Value
17756,2010-11-29 12:20:00,3,728.75,374,2,3,2,7,Other
17757,2011-12-08 15:31:00,56,9070.1,0,4,4,4,12,High-Value
17758,2011-11-20 14:45:00,12,4964.03,18,4,4,4,12,High-Value
17759,2011-11-22 16:02:00,5,1260.63,16,4,3,3,10,High-Value
17760,2011-11-18 10:56:00,6,746.39,20,4,3,2,9,High-Value
17761,2011-11-07 10:23:00,1,712.78,31,3,1,2,6,Other
17762,2010-09-09 17:40:00,1,129.75,455,1,1,1,3,At-Risk
17763,2011-03-21 14:25:00,4,86.15,262,2,3,1,6,Other
17764,2011-10-20 11:03:00,5,1513.57,49,3,3,3,9,High-Value
17765,2011-07-04 12:41:00,4,524.0,157,2,3,2,7,Other
17766,2010-11-23 14:29:00,2,299.61,380,1,2,1,4,At-Risk
17767,2011-11-24 14:42:00,2,413.05,14,4,2,2,8,Other
17768,2011-12-01 13:22:00,7,3292.73,7,4,4,4,12,High-Value
17769,2011-11-27 11:18:00,17,7053.38,11,4,4,4,12,High-Value
17770,2011-05-25 12:34:00,5,1143.27,197,2,3,3,8,Other
17771,2011-10-14 11:43:00,4,386.93,55,3,3,2,8,Loyal
17772,2011-11-29 11:05:00,3,360.75,9,4,3,2,9,High-Value
17773,2010-07-13 14:07:00,2,575.37,513,1,2,2,5,At-Risk
17774,2011-09-04 12:49:00,9,3272.83,95,2,4,4,10,High-Value
17775,2011-03-30 10:50:00,1,56.4,253,2,1,1,4,One-Time
17776,2010-11-18 12:14:00,2,329.3,385,1,2,1,4,At-Risk
17777,2011-11-15 12:02:00,3,647.56,23,4,3,2,9,High-Value
17778,2010-02-16 12:44:00,1,197.7,660,1,1,1,3,At-Risk
17779,2011-11-18 14:15:00,3,650.32,20,4,3,2,9,High-Value
17780,2010-02-10 13:43:00,3,346.56,666,1,3,2,6,At-Risk
17781,2011-07-03 16:00:00,2,188.02,158,2,2,1,5,Other
17782,2010-11-22 11:15:00,2,679.02,381,1,2,2,5,At-Risk
17783,2011-09-28 16:07:00,3,376.96,71,3,3,2,8,Loyal
17784,2010-06-07 16:08:00,1,112.86,549,1,1,1,3,At-Risk
17785,2011-10-17 13:43:00,3,403.38,52,3,3,2,8,Loyal
17786,2011-09-15 12:51:00,2,266.85,84,3,2,1,6,Other
17787,2011-07-10 11:24:00,4,1817.54,151,2,3,3,8,Other
17788,2011-09-27 10:09:00,2,1112.95,72,3,2,3,8,Other
17789,2011-03-03 13:14:00,2,397.15,280,2,2,2,6,Other
17790,2011-11-13 11:30:00,20,2779.41,25,3,4,4,11,High-Value
17791,2011-11-10 12:09:00,1,106.1,28,3,1,1,5,One-Time
17792,2010-08-29 14:30:00,2,368.35,466,1,2,2,5,At-Risk
17793,2011-11-14 14:24:00,1,300.34,24,4,1,1,6,One-Time
17794,2010-01-22 10:18:00,2,147.3,685,1,2,1,4,At-Risk
17795,2011-06-13 12:36:00,2,342.83,178,2,2,2,6,Other
17796,2011-10-30 15:38:00,7,1236.39,39,3,4,3,10,High-Value
17797,2011-11-17 13:21:00,8,1971.87,21,4,4,3,11,High-Value
17798,2010-05-07 11:42:00,1,172.17,580,1,1,1,3,At-Risk
17799,2011-11-17 15:16:00,20,6246.93,21,4,4,4,12,High-Value
17800,2011-11-02 12:57:00,9,1186.21,36,3,4,3,10,High-Value
17801,2010-09-14 14:32:00,3,770.03,450,1,3,2,6,At-Risk
17802,2011-09-18 14:56:00,10,4946.22,81,3,4,4,11,High-Value
17803,2010-11-12 13:53:00,1,184.66,391,1,1,1,3,At-Risk
17804,2010-11-28 14:01:00,3,383.78,375,2,3,2,7,Other
17805,2011-09-27 11:49:00,2,927.03,72,3,2,3,8,Other
17806,2011-11-28 14:12:00,1,546.04,10,4,1,2,7,Other
17807,2010-11-09 16:21:00,3,437.87,394,1,3,2,6,At-Risk
17808,2010-06-09 10:44:00,4,262.64,547,1,3,1,5,At-Risk
17809,2011-11-23 12:59:00,20,10085.89,15,4,4,4,12,High-Value
17810,2010-02-09 10:47:00,2,343.21,667,1,2,2,5,At-Risk
17811,2011-12-05 13:46:00,47,9513.1,3,4,4,4,12,High-Value
17812,2011-11-27 11:47:00,7,911.99,11,4,4,3,11,High-Value
17813,2011-11-25 16:13:00,5,1698.07,13,4,3,3,10,High-Value
17814,2010-11-29 14:21:00,2,1609.37,374,2,2,3,7,Other
17815,2010-11-11 14:39:00,1,591.96,392,1,1,2,4,At-Risk
17816,2011-11-03 11:34:00,6,96.11,35,3,3,1,7,Loyal
17817,2011-12-05 14:39:00,6,788.15,3,4,3,2,9,High-Value
17818,2009-12-02 11:34:00,1,124.78,736,1,1,1,3,At-Risk
17819,2011-09-29 10:52:00,12,6021.05,70,3,4,4,11,High-Value
17820,2010-11-30 17:43:00,1,180.61,373,2,1,1,4,One-Time
17821,2010-10-29 13:20:00,1,334.62,405,1,1,1,3,At-Risk
17822,2010-10-15 13:47:00,5,2154.08,419,1,3,3,7,At-Risk
17823,2010-10-14 16:24:00,2,449.25,420,1,2,2,5,At-Risk
17824,2011-10-19 14:14:00,1,298.4,50,3,1,1,5,One-Time
17825,2010-04-20 12:01:00,4,701.96,597,1,3,2,6,At-Risk
17826,2010-11-30 13:23:00,1,133.34,373,2,1,1,4,One-Time
17827,2011-12-04 15:00:00,6,2376.17,4,4,3,4,11,High-Value
17828,2011-11-17 08:41:00,4,1165.09,21,4,3,3,10,High-Value
17829,2011-02-14 12:46:00,5,4756.74,297,2,3,4,9,High-Value
17830,2011-12-08 12:28:00,3,398.7,0,4,3,2,9,High-Value
17831,2011-11-06 15:09:00,1,35.4,32,3,1,1,5,One-Time
17832,2011-10-21 11:43:00,1,155.37,48,3,1,1,5,One-Time
17833,2009-12-16 13:40:00,1,338.46,722,1,1,1,3,At-Risk
17834,2010-10-21 12:09:00,2,689.67,413,1,2,2,5,At-Risk
17835,2011-12-07 11:48:00,3,342.24,1,4,3,2,9,High-Value
17836,2011-10-23 16:13:00,1,109.83,46,3,1,1,5,One-Time
17837,2011-10-28 16:13:00,8,1535.33,41,3,4,3,10,High-Value
17838,2011-11-13 11:20:00,13,5604.64,25,3,4,4,11,High-Value
17839,2011-10-28 17:27:00,1,318.15,41,3,1,1,5,One-Time
17840,2010-09-22 12:24:00,1,175.9,442,1,1,1,3,At-Risk
17841,2011-12-08 12:07:00,211,68519.95,0,4,4,4,12,High-Value
17842,2010-04-16 14:23:00,1,430.69,601,1,1,2,4,At-Risk
17843,2011-02-09 15:33:00,2,312.65,302,2,2,1,5,Other
17844,2011-08-25 11:27:00,1,51.56,105,2,1,1,4,One-Time
17845,2010-06-02 15:20:00,4,596.09,554,1,3,2,6,At-Risk
17847,2010-07-12 10:00:00,2,125.74,514,1,2,1,4,At-Risk
17848,2011-09-19 16:49:00,30,3538.46,80,3,4,4,11,High-Value
17849,2011-05-05 13:46:00,8,1063.76,217,2,4,3,9,High-Value
17850,2010-12-02 15:27:00,155,51208.87,371,2,4,4,10,High-Value
17851,2010-10-13 15:13:00,6,1552.35,421,1,3,3,7,At-Risk
17852,2011-11-28 12:36:00,5,657.81,10,4,3,2,9,High-Value
17853,2010-10-28 15:29:00,3,1596.29,406,1,3,3,7,At-Risk
17854,2011-06-07 16:21:00,6,1068.5,184,2,3,3,8,Other
17855,2010-12-02 09:44:00,1,208.97,371,2,1,1,4,One-Time
17856,2011-12-08 09:40:00,4,1418.03,0,4,3,3,10,High-Value
17857,2011-12-05 13:13:00,23,25769.54,3,4,4,4,12,High-Value
17858,2011-12-04 11:56:00,30,12518.65,4,4,4,4,12,High-Value
17859,2011-02-08 10:32:00,1,141.92,303,2,1,1,4,One-Time
17860,2010-12-06 12:41:00,4,717.39,367,2,3,2,7,Other
17861,2011-12-06 16:21:00,18,5088.29,2,4,4,4,12,High-Value
17862,2011-01-20 12:23:00,4,1254.89,322,2,3,3,8,Other
17863,2011-10-11 13:45:00,12,5360.48,58,3,4,4,11,High-Value
17864,2011-11-27 11:15:00,5,876.57,11,4,3,3,10,High-Value
17865,2011-11-09 12:08:00,46,26310.09,29,3,4,4,11,High-Value
17866,2011-07-20 11:07:00,3,1134.95,141,2,3,3,8,Other
17867,2011-11-09 14:15:00,14,1560.72,29,3,4,3,10,High-Value
17868,2010-11-18 18:55:00,1,227.15,385,1,1,1,3,At-Risk
17869,2011-08-24 16:16:00,7,813.64,106,2,4,2,8,Other
17870,2011-12-07 15:07:00,13,2753.29,1,4,4,4,12,High-Value
17871,2011-05-19 11:32:00,5,1068.95,203,2,3,3,8,Other
17872,2010-11-23 12:02:00,1,235.87,380,1,1,1,3,At-Risk
17873,2011-09-20 16:41:00,18,6135.95,79,3,4,4,11,High-Value
17874,2011-06-07 12:54:00,6,683.46,184,2,3,2,7,Other
17875,2010-01-20 15:30:00,1,167.1,687,1,2,1,4,At-Risk
17876,2010-11-05 10:52:00,3,3424.02,398,1,3,4,8,At-Risk
17877,2011-06-22 13:00:00,1,237.61,169,2,2,1,5,Other
17878,2011-10-27 11:24:00,3,1378.93,42,3,3,3,9,High-Value
17879,2011-06-19 12:36:00,1,178.52,172,2,2,1,5,Other
17880,2010-12-10 10:21:00,3,824.92,363,2,3,2,7,Other
17881,2011-02-08 17:16:00,1,133.35,303,2,2,1,5,Other
17882,2010-11-25 14:40:00,2,291.56,378,2,2,1,5,Other
17883,2011-12-06 17:49:00,7,988.42,2,4,4,3,11,High-Value
17884,2011-12-06 11:33:00,20,2693.47,2,4,4,4,12,High-Value
17885,2011-11-27 14:40:00,1,156.34,11,4,2,1,7,Other
17886,2011-11-08 10:09:00,6,1572.55,30,3,3,3,9,High-Value
17887,2011-08-02 17:29:00,1,111.35,128,2,2,1,5,Other
17888,2011-11-18 13:45:00,25,1807.44,20,4,4,3,11,High-Value
17889,2011-05-11 16:26:00,7,746.42,211,2,4,2,8,Other
17890,2011-01-21 11:19:00,2,586.89,321,2,2,2,6,Other
17891,2011-06-30 20:08:00,1,203.86,161,2,2,1,5,Other
17892,2011-10-14 16:49:00,3,244.1,55,3,3,1,7,Loyal
17893,2011-04-28 13:50:00,1,107.21,224,2,2,1,5,Other
17894,2011-09-29 09:23:00,18,2304.16,70,3,4,4,11,High-Value
17895,2011-10-26 17:00:00,1,95.45,43,3,2,1,6,Other
17896,2011-11-16 13:59:00,1,256.32,22,4,2,1,7,Other
17897,2011-06-20 11:23:00,9,2053.04,171,2,4,3,9,High-Value
17898,2011-09-15 14:56:00,4,299.18,84,3,3,1,7,Loyal
17899,2011-07-03 14:58:00,1,154.55,158,2,2,1,5,Other
17900,2011-06-02 14:38:00,2,112.2,189,2,2,1,5,Other
17901,2011-11-10 17:29:00,3,260.08,28,3,3,1,7,Loyal
17902,2010-06-11 12:25:00,1,216.4,545,1,2,1,4,At-Risk
17903,2010-11-10 15:39:00,1,381.09,393,1,2,2,5,At-Risk
17904,2011-11-18 12:57:00,1,181.07,20,4,2,1,7,Other
17905,2011-09-29 17:33:00,13,2168.37,70,3,4,3,10,High-Value
17906,2011-04-06 17:25:00,1,72.9,246,2,2,1,5,Other
17907,2010-03-09 12:33:00,1,291.76,639,1,2,1,4,At-Risk
17908,2010-12-01 11:45:00,5,1142.47,372,2,3,3,8,Other
17909,2009-12-02 13:10:00,1,110.05,736,1,2,1,4,At-Risk
17910,2009-12-13 16:04:00,1,261.7,725,1,2,1,4,At-Risk
17911,2011-11-30 14:52:00,1,366.23,8,4,2,2,8,Other
17912,2011-02-02 14:25:00,6,371.6,309,2,3,2,7,Other
17913,2011-10-12 10:45:00,14,3425.09,57,3,4,4,11,High-Value
17914,2011-12-06 11:58:00,1,329.36,2,4,2,1,7,Other
17915,2010-06-06 13:22:00,1,225.78,550,1,2,1,4,At-Risk
17916,2010-03-21 12:26:00,2,43.87,627,1,2,1,4,At-Risk
17917,2011-10-25 13:20:00,3,335.03,44,3,3,1,7,Loyal
17918,2010-07-27 11:51:00,3,388.44,499,1,3,2,6,At-Risk
17919,2011-09-12 13:41:00,2,1840.32,87,3,2,3,8,Other
17920,2011-12-05 14:29:00,54,23569.88,3,4,4,4,12,High-Value
17921,2011-10-06 18:56:00,10,2394.36,63,3,4,4,11,High-Value
17922,2010-06-14 16:32:00,1,170.4,542,1,2,1,4,At-Risk
17923,2011-03-02 15:15:00,3,497.0,281,2,3,2,7,Other
17924,2011-11-28 09:11:00,8,3257.7,10,4,4,4,12,High-Value
17925,2010-12-02 10:10:00,1,244.08,371,2,2,1,5,Other
17926,2011-07-29 14:39:00,5,1035.49,132,2,3,3,8,Other
17927,2009-12-18 11:03:00,1,294.0,720,1,2,1,4,At-Risk
17928,2011-10-25 13:52:00,3,313.16,44,3,3,1,7,Loyal
17929,2011-11-28 16:01:00,12,3082.1,10,4,4,4,12,High-Value
17930,2011-11-04 10:23:00,13,4275.22,34,3,4,4,11,High-Value
17931,2011-07-28 18:33:00,14,3402.24,133,2,4,4,10,High-Value
17932,2011-11-10 19:49:00,3,1331.57,28,3,3,3,9,High-Value
17933,2010-03-17 15:11:00,1,105.99,631,1,2,1,4,At-Risk
17934,2011-10-19 11:16:00,3,1049.15,50,3,3,3,9,High-Value
17935,2011-07-24 13:18:00,7,683.24,137,2,4,2,8,Other
17936,2011-12-04 13:32:00,1,380.13,4,4,2,2,8,Other
17937,2011-12-01 11:45:00,7,4301.22,7,4,4,4,12,High-Value
17938,2010-10-15 14:27:00,1,144.29,419,1,2,1,4,At-Risk
17939,2011-07-03 12:27:00,1,99.14,158,2,2,1,5,Other
17940,2011-10-21 13:27:00,14,28389.58,48,3,4,4,11,High-Value
17941,2011-08-01 08:30:00,4,1433.28,129,2,3,3,8,Other
17942,2011-12-02 10:45:00,1,77.5,6,4,2,1,7,Other
17944,2010-10-12 16:25:00,1,74.99,422,1,2,1,4,At-Risk
17945,2010-01-12 11:40:00,3,359.5,695,1,3,2,6,At-Risk
17946,2011-04-20 17:00:00,2,149.58,232,2,2,1,5,Other
17947,2011-11-02 13:05:00,1,176.68,36,3,2,1,6,Other
17948,2011-07-15 12:58:00,1,358.56,146,2,2,2,6,Other
17949,2011-12-08 18:46:00,116,107833.48,0,4,4,4,12,High-Value
17950,2011-09-28 15:18:00,7,1166.29,71,3,4,3,10,High-Value
17951,2011-10-31 12:30:00,4,1340.58,38,3,3,3,9,High-Value
17952,2010-11-26 13:54:00,4,788.46,377,2,3,2,7,Other
17953,2010-06-17 15:08:00,1,148.67,539,1,2,1,4,At-Risk
17954,2011-12-04 14:15:00,19,3801.83,4,4,4,4,12,High-Value
17955,2011-05-25 12:00:00,6,949.9,197,2,3,3,8,Other
17956,2011-04-04 13:47:00,1,12.75,248,2,2,1,5,Other
17957,2011-10-04 14:58:00,1,110.72,65,3,2,1,6,Other
17958,2011-08-15 12:19:00,2,973.88,115,2,2,3,7,Other
17959,2010-04-26 14:12:00,1,140.75,591,1,2,1,4,At-Risk
17960,2011-06-21 14:15:00,3,135.08,170,2,3,1,6,Other
17961,2011-11-18 16:55:00,100,2866.74,20,4,4,4,12,High-Value
17962,2011-07-20 14:16:00,4,665.91,141,2,3,2,7,Other
17963,2010-08-25 15:58:00,4,643.16,470,1,3,2,6,At-Risk
17964,2011-11-08 10:44:00,2,463.21,30,3,2,2,7,Other
17965,2011-11-02 09:31:00,29,7002.9,36,3,4,4,11,High-Value
17966,2011-11-02 10:26:00,10,1963.92,36,3,4,3,10,High-Value
17967,2010-12-03 11:19:00,2,223.42,370,2,2,1,5,Other
17968,2010-12-01 12:23:00,4,590.44,372,2,3,2,7,Other
17969,2011-06-26 13:00:00,20,2354.29,165,2,4,4,10,High-Value
17970,2011-05-12 20:03:00,1,562.79,210,2,2,2,6,Other
17971,2010-06-09 14:04:00,1,161.94,547,1,2,1,4,At-Risk
17972,2011-04-12 12:16:00,1,135.19,240,2,2,1,5,Other
17973,2011-10-19 10:34:00,1,337.04,50,3,2,1,6,Other
17974,2011-11-15 11:37:00,6,1739.09,23,4,3,3,10,High-Value
17975,2011-11-24 13:27:00,24,6693.03,14,4,4,4,12,High-Value
17976,2010-12-02 13:49:00,1,321.79,371,2,2,1,5,Other
17977,2011-11-10 13:28:00,2,1511.45,28,3,2,3,8,Other
17978,2010-12-09 14:05:00,4,1159.99,364,2,3,3,8,Other
17979,2011-11-04 12:05:00,4,729.01,34,3,3,2,8,Loyal
17980,2011-06-27 12:01:00,4,1012.72,164,2,3,3,8,Other
17981,2010-10-25 10:40:00,1,239.12,409,1,2,1,4,At-Risk
17982,2010-01-28 09:38:00,1,138.18,679,1,2,1,4,At-Risk
17983,2010-11-09 13:23:00,1,171.71,394,1,2,1,4,At-Risk
17984,2011-07-17 15:59:00,5,1148.69,144,2,3,3,8,Other
17985,2011-11-17 14:24:00,1,631.35,21,4,2,2,8,Other
17986,2011-10-14 14:22:00,1,20.8,55,3,2,1,6,Other
17987,2011-06-07 14:22:00,5,965.44,184,2,3,3,8,Other
17988,2011-11-28 11:00:00,13,485.69,10,4,4,2,10,High-Value
17989,2010-11-25 13:49:00,1,207.33,378,2,2,1,5,Other
17990,2011-04-17 11:44:00,6,1527.61,235,2,3,3,8,Other
17991,2011-04-28 15:58:00,3,298.65,224,2,3,1,6,Other
17992,2010-11-15 13:04:00,1,252.88,388,1,2,1,4,At-Risk
17993,2010-04-01 14:23:00,1,225.99,616,1,2,1,4,At-Risk
17994,2011-08-10 11:41:00,11,2264.03,120,2,4,4,10,High-Value
17995,2011-03-03 12:30:00,3,495.48,280,2,3,2,7,Other
17996,2010-11-25 11:00:00,3,469.73,378,2,3,2,7,Other
17997,2011-09-26 16:13:00,8,1962.46,73,3,4,3,10,High-Value
17998,2010-11-24 15:31:00,3,639.24,379,1,3,2,6,At-Risk
17999,2011-11-02 15:56:00,3,528.46,36,3,3,2,8,Loyal
18000,2010-05-24 17:34:00,1,124.25,563,1,2,1,4,At-Risk
18001,2011-11-27 16:02:00,6,924.14,11,4,3,3,10,High-Value
18002,2010-11-29 10:57:00,4,237.62,374,2,3,1,6,Other
18003,2010-11-28 15:09:00,1,353.51,375,2,2,2,6,Other
18004,2010-12-12 13:47:00,1,157.92,361,2,2,1,5,Other
18005,2011-12-06 11:51:00,2,226.47,2,4,2,1,7,Other
18006,2011-11-16 16:52:00,4,969.51,22,4,3,3,10,High-Value
18007,2010-11-12 11:08:00,1,215.22,391,1,2,1,4,At-Risk
18008,2011-09-30 15:17:00,23,19759.08,69,3,4,4,11,High-Value
18009,2011-04-18 13:36:00,8,2144.23,234,2,4,3,9,High-Value
18010,2011-03-28 12:27:00,1,174.8,255,2,2,1,5,Other
18011,2010-12-01 17:35:00,2,410.79,372,2,2,2,6,Other
18012,2009-12-16 13:16:00,1,115.3,722,1,2,1,4,At-Risk
18013,2011-07-07 14:11:00,2,187.29,154,2,2,1,5,Other
18014,2011-11-11 15:28:00,1,154.27,27,3,2,1,6,Other
18015,2011-12-05 14:49:00,1,120.03,3,4,2,1,7,Other
18016,2011-11-07 13:25:00,7,1954.56,31,3,4,3,10,High-Value
18017,2011-09-19 16:15:00,4,688.0,80,3,3,2,8,Loyal
18018,2011-08-23 17:37:00,4,297.99,107,2,3,1,6,Other
18019,2011-10-19 12:10:00,1,38.45,50,3,2,1,6,Other
18020,2010-06-14 12:31:00,1,190.48,542,1,2,1,4,At-Risk
18021,2010-07-18 10:52:00,2,216.41,508,1,2,1,4,At-Risk
18022,2011-11-04 12:45:00,5,1506.62,34,3,3,3,9,High-Value
18024,2011-07-10 12:40:00,2,389.78,151,2,2,2,6,Other
18025,2010-11-25 12:37:00,6,1177.72,378,2,3,3,8,Other
18026,2010-07-27 10:37:00,2,2074.07,499,1,2,3,6,At-Risk
18027,2011-09-02 10:38:00,1,115.31,97,2,2,1,5,Other
18028,2010-05-05 13:28:00,1,192.05,582,1,2,1,4,At-Risk
18029,2010-03-07 15:30:00,1,433.77,641,1,2,2,5,At-Risk
18030,2011-12-05 16:37:00,2,230.65,3,4,2,1,7,Other
18031,2010-11-26 11:00:00,1,451.3,377,2,2,2,6,Other
18032,2011-01-09 15:32:00,1,73.5,333,2,2,1,5,Other
18033,2011-10-05 17:28:00,1,93.82,64,3,2,1,6,Other
18034,2011-11-18 12:22:00,3,753.35,20,4,3,2,9,High-Value
18035,2011-11-04 12:39:00,5,1260.23,34,3,3,3,9,High-Value
18036,2011-11-07 14:40:00,11,1545.49,31,3,4,3,10,High-Value
18037,2011-07-08 13:39:00,15,167.42,153,2,4,1,7,Other
18038,2010-06-01 15:59:00,1,141.48,555,1,2,1,4,At-Risk
18039,2010-11-30 13:07:00,4,548.22,373,2,3,2,7,Other
18040,2011-11-20 14:20:00,2,357.2,18,4,2,2,8,Other
18041,2011-11-28 11:39:00,38,8018.77,10,4,4,4,12,High-Value
18042,2011-10-17 11:49:00,2,281.15,52,3,2,1,6,Other
18043,2011-11-15 12:48:00,3,529.29,23,4,3,2,9,High-Value
18044,2011-12-05 14:26:00,18,3505.61,3,4,4,4,12,High-Value
18045,2011-10-25 13:07:00,1,178.34,44,3,2,1,6,Other
18046,2010-02-28 11:36:00,1,189.63,648,1,2,1,4,At-Risk
18047,2010-11-23 13:11:00,2,326.09,380,1,2,1,4,At-Risk
18048,2011-05-20 14:58:00,3,394.93,202,2,3,2,7,Other
18049,2010-09-28 14:26:00,2,500.5,436,1,2,2,5,At-Risk
18050,2010-12-15 14:25:00,2,412.06,358,2,2,2,6,Other
18051,2010-03-15 13:58:00,7,2282.28,633,1,4,4,9,High-Value
18052,2010-05-24 11:11:00,1,10877.18,563,1,2,4,7,At-Risk
18053,2011-09-30 09:05:00,3,571.07,69,3,3,2,8,Loyal
18054,2010-11-12 08:18:00,1,176.5,391,1,2,1,4,At-Risk
18055,2011-12-02 14:25:00,14,10142.64,6,4,4,4,12,High-Value
18056,2011-02-24 14:27:00,2,554.6,287,2,2,2,6,Other
18057,2010-11-11 16:55:00,3,1168.14,392,1,3,3,7,At-Risk
18058,2011-11-30 08:38:00,3,774.06,8,4,3,2,9,High-Value
18059,2011-11-16 16:49:00,3,306.46,22,4,3,1,8,Loyal
18060,2010-10-27 16:41:00,2,1185.46,407,1,2,3,6,At-Risk
18061,2011-11-18 11:20:00,28,6083.81,20,4,4,4,12,High-Value
18062,2011-06-19 14:47:00,6,1632.67,172,2,3,3,8,Other
18063,2010-11-14 10:46:00,2,186.6,389,1,2,1,4,At-Risk
18064,2011-07-29 16:39:00,11,4481.83,132,2,4,4,10,High-Value
18065,2011-12-04 10:30:00,28,5846.63,4,4,4,4,12,High-Value
18066,2011-09-25 15:30:00,3,1440.4,74,3,3,3,9,High-Value
18067,2011-10-30 15:58:00,1,396.33,39,3,2,2,7,Other
18068,2011-02-23 14:50:00,1,101.7,288,2,2,1,5,Other
18069,2011-11-13 16:03:00,11,4449.02,25,3,4,4,11,High-Value
18070,2010-02-08 13:28:00,1,314.1,668,1,2,1,4,At-Risk
18071,2011-03-27 11:59:00,6,1169.68,256,2,3,3,8,Other
18072,2011-06-07 10:44:00,1,247.44,184,2,2,1,5,Other
18073,2011-08-17 14:02:00,12,3859.82,113,2,4,4,10,High-Value
18074,2010-12-01 09:53:00,2,1019.44,372,2,2,3,7,Other
18075,2011-11-16 15:21:00,20,5783.29,22,4,4,4,12,High-Value
18076,2010-11-24 14:02:00,1,151.49,379,1,2,1,4,At-Risk
18077,2011-12-01 13:32:00,18,4078.79,7,4,4,4,12,High-Value
18078,2011-05-06 14:32:00,4,725.53,216,2,3,2,7,Other
18079,2011-10-25 15:27:00,5,4203.93,44,3,3,4,10,High-Value
18080,2011-11-21 08:02:00,2,1231.5,17,4,2,3,9,High-Value
18081,2011-11-03 16:30:00,3,343.45,35,3,3,2,8,Loyal
18082,2011-11-14 12:45:00,1,680.84,24,4,2,2,8,Other
18083,2010-11-07 11:44:00,1,463.53,396,1,2,2,5,At-Risk
18084,2011-11-23 13:57:00,3,795.23,15,4,3,2,9,High-Value
18085,2011-01-13 15:17:00,4,1341.85,329,2,3,3,8,Other
18086,2011-03-10 13:34:00,1,101.34,273,2,2,1,5,Other
18087,2011-02-22 10:43:00,16,13908.72,289,2,4,4,10,High-Value
18088,2011-10-09 13:41:00,1,166.03,60,3,2,1,6,Other
18089,2010-09-19 11:57:00,1,428.45,445,1,2,2,5,At-Risk
18090,2010-10-14 12:32:00,1,321.9,420,1,2,1,4,At-Risk
18091,2010-04-25 13:18:00,1,360.85,592,1,2,2,5,At-Risk
18092,2011-12-07 13:14:00,18,14693.72,1,4,4,4,12,High-Value
18093,2011-09-07 15:43:00,8,4452.71,92,3,4,4,11,High-Value
18094,2011-09-19 09:28:00,13,6391.52,80,3,4,4,11,High-Value
18095,2011-01-31 12:50:00,5,2303.09,311,2,3,4,9,High-Value
18096,2011-11-28 12:44:00,6,1638.16,10,4,3,3,10,High-Value
18097,2011-12-02 11:16:00,11,4627.92,6,4,4,4,12,High-Value
18098,2010-11-08 16:31:00,1,527.94,395,1,2,2,5,At-Risk
18099,2011-08-04 15:52:00,1,168.31,126,2,2,1,5,Other
18100,2010-06-07 14:19:00,1,451.56,549,1,2,2,5,At-Risk
18101,2011-11-28 13:37:00,5,622.01,10,4,3,2,9,High-Value
18102,2011-12-09 11:50:00,145,580987.04,-1,4,4,4,12,High-Value
18103,2010-06-08 13:36:00,1,105.8,548,1,2,1,4,At-Risk
18104,2011-11-02 14:07:00,1,754.64,36,3,2,2,7,Other
18105,2011-11-02 12:04:00,1,113.48,36,3,2,1,6,Other
18106,2011-01-14 12:23:00,6,1441.06,328,2,3,3,8,Other
18107,2010-09-23 13:03:00,1,165.88,441,1,2,1,4,At-Risk
18108,2011-03-30 13:56:00,3,848.81,253,2,3,2,7,Other
18109,2011-12-08 11:36:00,38,9555.71,0,4,4,4,12,High-Value
18110,2011-11-20 12:34:00,2,392.28,18,4,2,2,8,Other
18111,2010-04-29 12:58:00,1,405.85,588,1,2,2,5,At-Risk
18112,2011-11-27 14:43:00,4,773.36,11,4,3,2,9,High-Value
18113,2010-12-06 12:31:00,1,76.32,367,2,2,1,5,Other
18114,2011-02-22 13:20:00,1,220.1,289,2,2,1,5,Other
18115,2010-01-11 11:57:00,1,9.7,696,1,2,1,4,At-Risk
18116,2011-10-03 11:00:00,13,2130.89,66,3,4,3,10,High-Value
18117,2011-11-14 12:47:00,1,314.4,24,4,2,1,7,Other
18118,2011-11-29 11:32:00,29,6218.62,9,4,4,4,12,High-Value
18119,2010-12-07 11:59:00,1,180.7,366,2,2,1,5,Other
18120,2011-05-09 13:45:00,1,111.15,213,2,2,1,5,Other
18121,2011-07-13 12:53:00,2,653.3,148,2,2,2,6,Other
18122,2011-12-01 13:08:00,6,1791.84,7,4,3,3,10,High-Value
18123,2011-11-15 14:23:00,3,666.64,23,4,3,2,9,High-Value
18124,2010-08-24 17:21:00,1,102.65,471,1,2,1,4,At-Risk
18125,2011-11-10 12:29:00,4,1131.75,28,3,3,3,9,High-Value
18126,2011-10-10 12:19:00,1,198.58,59,3,2,1,6,Other
18127,2011-11-20 14:05:00,4,556.13,18,4,3,2,9,High-Value
18128,2010-06-20 13:19:00,1,399.29,536,1,2,2,5,At-Risk
18129,2011-04-10 14:16:00,1,112.55,242,2,2,1,5,Other
18130,2011-11-24 14:40:00,3,1059.39,14,4,3,3,10,High-Value
18131,2010-03-18 08:48:00,1,222.96,630,1,2,1,4,At-Risk
18132,2010-07-23 16:54:00,1,220.13,503,1,2,1,4,At-Risk
18133,2011-05-11 14:14:00,1,931.5,211,2,2,3,7,Other
18134,2010-04-20 14:02:00,2,445.0,597,1,2,2,5,At-Risk
18135,2011-11-10 19:32:00,10,1249.62,28,3,4,3,10,High-Value
18136,2011-10-07 15:40:00,5,1631.36,62,3,3,3,9,High-Value
18137,2010-06-06 14:18:00,2,145.99,550,1,2,1,4,At-Risk
18138,2011-02-17 14:51:00,1,152.65,294,2,2,1,5,Other
18139,2011-11-22 10:44:00,6,8438.34,16,4,3,4,11,High-Value
18140,2010-08-23 11:58:00,1,536.41,472,1,2,2,5,At-Risk
18141,2010-11-03 11:44:00,2,882.47,400,1,2,3,6,At-Risk
18142,2011-07-05 13:19:00,2,1019.52,156,2,2,3,7,Other
18143,2011-08-15 12:07:00,2,1000.16,115,2,2,3,7,Other
18144,2011-12-02 12:46:00,19,4892.95,6,4,4,4,12,High-Value
18145,2011-11-27 11:22:00,11,5609.74,11,4,4,4,12,High-Value
18146,2011-07-22 12:08:00,2,160.35,139,2,2,1,5,Other
18147,2011-10-25 11:46:00,2,179.34,44,3,2,1,6,Other
18148,2010-03-03 11:40:00,1,112.85,645,1,2,1,4,At-Risk
18149,2011-10-20 12:04:00,7,1553.96,49,3,4,3,10,High-Value
18150,2011-11-07 16:49:00,3,566.58,31,3,3,2,8,Loyal
18151,2011-07-28 11:35:00,6,1879.44,133,2,3,3,8,Other
18152,2010-03-03 15:26:00,1,426.69,645,1,2,2,5,At-Risk
18153,2010-02-18 15:50:00,1,246.22,658,1,2,1,4,At-Risk
18154,2011-12-06 16:41:00,5,932.6,2,4,3,3,10,High-Value
18155,2011-09-25 13:32:00,3,371.62,74,3,3,2,8,Loyal
18156,2011-11-27 12:24:00,2,675.64,11,4,2,2,8,Other
18157,2010-05-17 14:09:00,1,213.9,570,1,2,1,4,At-Risk
18158,2011-11-30 16:19:00,2,453.4,8,4,2,2,8,Other
18159,2011-02-11 14:26:00,1,530.15,300,2,2,2,6,Other
18160,2011-10-13 15:50:00,3,1003.88,56,3,3,3,9,High-Value
18161,2011-11-24 16:40:00,6,1803.1,14,4,3,3,10,High-Value
18162,2009-12-07 13:24:00,1,371.51,731,1,2,2,5,At-Risk
18163,2010-05-04 14:51:00,1,728.84,583,1,2,2,5,At-Risk
18164,2011-11-02 12:56:00,1,399.65,36,3,2,2,7,Other
18165,2011-06-15 13:23:00,1,302.46,176,2,2,1,5,Other
18166,2010-03-26 12:26:00,1,175.5,622,1,2,1,4,At-Risk
18167,2011-11-16 15:56:00,3,1384.86,22,4,3,3,10,High-Value
18168,2011-06-16 19:21:00,16,3435.5,175,2,4,4,10,High-Value
18169,2011-10-10 12:18:00,1,202.65,59,3,2,1,6,Other
18170,2011-11-06 14:35:00,9,2878.0,32,3,4,4,11,High-Value
18171,2011-10-12 09:13:00,9,2437.31,57,3,4,4,11,High-Value
18172,2011-11-25 11:12:00,52,17467.24,13,4,4,4,12,High-Value
18173,2011-09-14 11:26:00,5,2696.36,85,3,3,4,10,High-Value
18174,2011-12-02 16:56:00,2,162.5,6,4,2,1,7,Other
18175,2010-02-02 10:25:00,1,176.1,674,1,2,1,4,At-Risk
18176,2010-12-16 15:45:00,1,476.35,357,2,2,2,6,Other
18177,2011-11-08 14:44:00,9,2216.32,30,3,4,3,10,High-Value
18178,2011-08-03 09:30:00,11,6103.74,127,2,4,4,10,High-Value
18179,2011-11-30 16:23:00,8,2547.55,8,4,4,4,12,High-Value
18180,2011-12-05 08:39:00,6,1843.75,3,4,3,3,10,High-Value
18181,2011-11-15 15:08:00,5,1188.34,23,4,3,3,10,High-Value
18182,2010-09-02 14:25:00,1,291.13,462,1,2,1,4,At-Risk
18183,2011-04-26 15:26:00,2,632.07,226,2,2,2,6,Other
18184,2011-11-24 15:28:00,1,49.8,14,4,2,1,7,Other
18185,2011-04-04 13:42:00,1,304.25,248,2,2,1,5,Other
18186,2009-12-17 10:22:00,1,329.58,721,1,2,1,4,At-Risk
18187,2010-03-18 09:49:00,1,724.89,630,1,2,2,5,At-Risk
18188,2011-11-24 16:46:00,6,3280.59,14,4,3,4,11,High-Value
18189,2011-09-23 12:40:00,3,1403.73,76,3,3,3,9,High-Value
18190,2011-05-31 14:48:00,5,745.62,191,2,3,2,7,Other
18191,2011-03-23 12:08:00,2,529.4,260,2,2,2,6,Other
18192,2011-09-29 09:53:00,1,957.97,70,3,2,3,8,Other
18193,2011-06-27 13:58:00,3,1207.35,164,2,3,3,8,Other
18194,2011-09-18 13:29:00,6,4162.04,81,3,3,4,10,High-Value
18195,2010-11-17 15:03:00,1,101.16,386,1,2,1,4,At-Risk
18196,2011-09-05 16:22:00,4,1455.27,94,3,3,3,9,High-Value
18197,2010-05-13 10:46:00,1,230.1,574,1,2,1,4,At-Risk
18198,2011-12-05 14:49:00,17,5425.56,3,4,4,4,12,High-Value
18199,2010-01-25 11:32:00,1,344.75,682,1,2,2,5,At-Risk
18200,2011-08-25 18:45:00,1,150.35,105,2,2,1,5,Other
18201,2009-12-17 08:55:00,1,447.53,721,1,2,2,5,At-Risk
18202,2011-05-24 12:12:00,3,1396.99,198,2,3,3,8,Other
18203,2011-07-05 13:07:00,4,482.52,156,2,3,2,7,Other
18204,2011-09-29 16:44:00,3,1975.35,70,3,3,3,9,High-Value
18205,2011-11-03 13:22:00,2,517.36,35,3,2,2,7,Other
18206,2010-06-04 13:47:00,1,314.66,552,1,2,1,4,At-Risk
18207,2010-07-28 14:26:00,1,544.47,498,1,2,2,5,At-Risk
18208,2010-05-23 11:54:00,1,360.08,564,1,2,2,5,At-Risk
18209,2011-11-11 12:07:00,1,139.1,27,3,2,1,6,Other
18210,2011-12-08 11:02:00,7,2768.83,0,4,4,4,12,High-Value
18211,2011-11-14 08:10:00,5,600.07,24,4,3,2,9,High-Value
18212,2011-01-17 16:14:00,2,514.37,325,2,2,2,6,Other
18213,2011-04-17 10:21:00,1,232.48,235,2,2,1,5,Other
18214,2010-06-27 11:21:00,4,1780.34,529,1,3,3,7,At-Risk
18215,2011-09-11 16:05:00,5,2232.49,88,3,3,3,9,High-Value
18216,2011-11-08 16:55:00,1,481.75,30,3,2,2,7,Other
18217,2011-11-10 13:18:00,4,945.04,28,3,3,3,9,High-Value
18218,2011-05-12 12:53:00,4,1121.84,210,2,3,3,8,Other
18219,2011-12-07 11:43:00,17,3352.7,1,4,4,4,12,High-Value
18220,2011-04-27 09:03:00,6,1921.76,225,2,3,3,8,Other
18221,2011-11-17 14:40:00,6,1424.94,21,4,3,3,10,High-Value
18222,2011-09-08 10:45:00,1,443.0,91,3,2,2,7,Other
18223,2011-12-05 09:11:00,26,14000.85,3,4,4,4,12,High-Value
18224,2011-03-21 10:30:00,1,158.95,262,2,2,1,5,Other
18225,2011-12-06 13:27:00,26,13014.8,2,4,4,4,12,High-Value
18226,2011-10-26 13:36:00,26,11878.88,43,3,4,4,11,High-Value
18227,2011-05-06 12:23:00,2,388.75,216,2,2,2,6,Other
18228,2011-10-14 09:21:00,2,779.9,55,3,2,2,7,Other
18229,2011-11-28 09:48:00,28,10150.51,10,4,4,4,12,High-Value
18230,2011-11-30 13:22:00,9,4291.06,8,4,4,4,12,High-Value
18231,2011-05-31 14:18:00,28,6848.27,191,2,4,4,10,High-Value
18232,2011-09-19 11:49:00,4,592.97,80,3,3,2,8,Loyal
18233,2011-01-18 08:44:00,1,440.0,324,2,2,2,6,Other
18234,2010-06-06 11:22:00,1,179.6,550,1,2,1,4,At-Risk
18235,2011-09-29 08:27:00,3,1796.48,70,3,3,3,9,High-Value
18236,2011-11-10 08:06:00,12,1795.35,28,3,4,3,10,High-Value
18237,2011-12-07 12:49:00,5,987.1,1,4,3,3,10,High-Value
18238,2010-07-12 12:51:00,1,270.92,514,1,2,1,4,At-Risk
18239,2011-05-05 12:38:00,6,1712.26,217,2,3,3,8,Other
18240,2011-10-24 13:06:00,1,422.58,45,3,2,2,7,Other
18241,2011-11-30 12:10:00,21,2986.99,8,4,4,4,12,High-Value
18242,2011-09-28 13:43:00,8,3605.21,71,3,4,4,11,High-Value
18243,2010-10-21 14:29:00,1,515.78,413,1,2,2,5,At-Risk
18244,2010-10-05 11:15:00,2,568.64,429,1,2,2,5,At-Risk
18245,2011-12-02 14:48:00,20,6324.98,6,4,4,4,12,High-Value
18246,2011-11-16 11:49:00,3,758.82,22,4,3,2,9,High-Value
18247,2010-10-21 09:49:00,3,839.73,413,1,3,2,6,At-Risk
18248,2011-08-09 10:19:00,2,804.02,121,2,2,2,6,Other
18249,2011-11-22 15:07:00,1,95.34,16,4,2,1,7,Other
18250,2011-02-02 13:16:00,1,349.27,309,2,2,2,6,Other
18251,2011-09-13 15:03:00,9,26278.86,86,3,4,4,11,High-Value
18252,2011-10-20 12:43:00,7,1533.69,49,3,4,3,10,High-Value
18253,2010-03-07 12:38:00,1,317.88,641,1,2,1,4,At-Risk
18254,2010-05-07 14:37:00,1,267.9,580,1,2,1,4,At-Risk
18255,2011-09-11 13:16:00,2,303.15,88,3,2,1,6,Other
18256,2010-11-17 08:53:00,1,110.7,386,1,2,1,4,At-Risk
18257,2011-10-31 14:48:00,12,4585.15,38,3,4,4,11,High-Value
18258,2010-09-01 14:20:00,6,2059.67,463,1,3,3,7,At-Risk
18259,2011-11-15 12:34:00,7,3941.9,23,4,4,4,12,High-Value
18260,2011-06-20 12:37:00,23,9947.26,171,2,4,4,10,High-Value
18261,2011-10-27 15:36:00,2,324.24,42,3,2,1,6,Other
18262,2011-07-22 16:04:00,3,577.54,139,2,3,2,7,Other
18263,2011-11-14 09:00:00,3,1213.16,24,4,3,3,10,High-Value
18264,2010-07-29 10:02:00,1,603.25,497,1,2,2,5,At-Risk
18265,2011-09-28 14:10:00,2,801.51,71,3,2,2,7,Other
18266,2010-10-01 15:33:00,1,251.1,433,1,2,1,4,At-Risk
18267,2010-02-05 08:43:00,1,269.37,671,1,2,1,4,At-Risk
18268,2011-07-28 19:13:00,6,1490.23,133,2,3,3,8,Other
18269,2010-12-08 13:53:00,1,168.6,365,2,2,1,5,Other
18270,2011-11-01 13:57:00,3,444.55,37,3,3,2,8,Loyal
18271,2010-04-09 09:26:00,2,680.85,608,1,2,2,5,At-Risk
18272,2011-12-07 12:43:00,9,4385.98,1,4,4,4,12,High-Value
18273,2011-12-07 13:16:00,4,357.0,1,4,3,2,9,High-Value
18274,2011-11-09 17:03:00,1,175.92,29,3,2,1,6,Other
18275,2010-05-10 15:46:00,2,741.85,577,1,2,2,5,At-Risk
18276,2011-10-27 10:54:00,6,1656.52,42,3,3,3,9,High-Value
18277,2011-10-12 15:22:00,5,1180.05,57,3,3,3,9,High-Value
18278,2011-09-27 11:58:00,2,414.2,72,3,2,2,7,Other
18279,2010-07-08 14:48:00,1,231.34,518,1,2,1,4,At-Risk
18280,2011-03-07 09:52:00,2,488.15,276,2,2,2,6,Other
18281,2011-06-12 10:53:00,2,201.14,179,2,2,1,5,Other
18282,2011-12-02 11:43:00,2,178.05,6,4,2,1,7,Other
18283,2011-12-06 12:02:00,22,2658.95,2,4,4,4,12,High-Value
18284,2010-10-04 11:33:00,1,411.68,430,1,2,2,5,At-Risk
18285,2010-02-17 10:24:00,1,377.0,659,1,2,2,5,At-Risk
18286,2010-08-20 11:57:00,2,1246.43,475,1,2,3,6,At-Risk
18287,2011-10-28 09:29:00,7,4132.99,41,3,4,4,11,High-Value
